人民币	人民币 ￥
日元	日元 ￥ 💴
日币	日币 ￥
美元	美元 $ 💵 💲
美刀	美刀 $
港元	港元 HK$
港币	港币 HK$
澳门元	澳门元 MOP$
澳门币	澳门币 MOP$
葡币	葡币 MOP$
新加坡元	新加坡元 S$
新加坡币	新加坡币 S$
欧元	欧元 € 💶
英镑	英镑 £ 💷
镑	镑 £
比特币	比特币 ₿
泰铢	泰铢 ฿
铢	铢 ฿
卢比	卢比 ₨
印度卢比	印度卢比 ₹
女	女 ♀
女性	女性 ♀
男	男 ♂
男性	男性 ♂
笑脸	笑脸 😀 😃 😄
露齿笑	露齿笑 😀 😃 😄 😆
哈	哈 😄
哈哈	哈哈 😄
开心	开心 😄
憨憨	憨憨 😄
笑	笑 😄 😊
高兴	高兴 😄
咧嘴笑	咧嘴笑 😁
嘻嘻	嘻嘻 😁
嘿嘿	嘿嘿 😁
傻笑	傻笑 😆
好耶	好耶 😆
眯眼笑	眯眼笑 😆
笑晕	笑晕 😆
笑死	笑死 😆
含泪	含泪 🥹
委屈	委屈 🥹
强忍泪水	强忍泪水 🥹
忍住泪水	忍住泪水 🥹
要哭了	要哭了 🥹
冒汗	冒汗 😅 😰 😓
冷汗	冷汗 😅 😰 😓
尴尬	尴尬 😅 😰 😓
无语	无语 😅 😰 😓
汗	汗 😅 😰 😓
苦笑	苦笑 😅
大笑	大笑 🤣 😂
打滚	打滚 🤣
笑出眼泪	笑出眼泪 🤣 😂
笑哭	笑哭 🤣 😂
笑哭了	笑哭了 🤣 😂
笑得打滚	笑得打滚 🤣
笑得满地打滚	笑得满地打滚 🤣
含泪的笑脸	含泪的笑脸 🥲
含泪笑脸	含泪笑脸 🥲
欣慰	欣慰 🥲
微笑	微笑 ☺ 😊
脸红	脸红 ☺ 😊 😳
光环	光环 😇
微笑天使	微笑天使 😇
呵呵	呵呵 🙂 🙃
倒脸	倒脸 🙃
颠倒	颠倒 🙃
颠倒的脸	颠倒的脸 🙃
媚眼	媚眼 😉
抛媚眼	抛媚眼 😉
眨眼	眨眼 😉
如释重负	如释重负 😌
松了一口气	松了一口气 😌
松了口气	松了口气 😌
松口气	松口气 😌
释然	释然 😌
喜欢	喜欢 😍 ♥️
花痴	花痴 😍
喜笑颜开	喜笑颜开 🥰
坠入爱河	坠入爱河 🥰
幸福	幸福 🥰
爱心环绕	爱心环绕 🥰
爱慕	爱慕 🥰
迷恋	迷恋 🥰
陷入爱河	陷入爱河 🥰
亲一下	亲一下 😘
亲一个	亲一个 😘
亲亲	亲亲 😘 😗 😙 😚
亲你	亲你 😘
啵一个	啵一个 😘
飞吻	飞吻 😘
噘嘴	噘嘴 😗 🙎‍♀️ 🙎 🙎‍♂️
微笑亲亲	微笑亲亲 😙
羞涩亲亲	羞涩亲亲 😚
好吃	好吃 😋
津津有味	津津有味 😋
美味	美味 😋
吐舌	吐舌 😛 😝 😜
吐舌头	吐舌头 😛 😝 😜
略略略	略略略 😛 😝 😜
嘲笑	嘲笑 😝
开玩笑	开玩笑 😝
眯眼	眯眼 😝
眯眼吐舌	眯眼吐舌 😝
单眼吐舌	单眼吐舌 😜
捣蛋	捣蛋 😜
调皮	调皮 😜
傻瓜	傻瓜 🤪
傻瓜脸	傻瓜脸 🤪
挑眉	挑眉 🤨
眉毛上挑	眉毛上挑 🤨
眉毛上挑的脸	眉毛上挑的脸 🤨
单片眼镜	单片眼镜 🧐
戴单片眼镜的脸	戴单片眼镜的脸 🧐
探究	探究 🧐
研究	研究 🧐
书呆子	书呆子 🤓
书呆子脸	书呆子脸 🤓
墨镜	墨镜 😎 🕶
墨镜笑脸	墨镜笑脸 😎
太阳镜	太阳镜 😎 🕶
自信	自信 😎
伪装	伪装 🥸
伪装的脸	伪装的脸 🥸
隐瞒身份	隐瞒身份 🥸
好崇拜	好崇拜 🤩
好崇拜哦	好崇拜哦 🤩
崇拜	崇拜 🤩
星星眼	星星眼 🤩
眼冒星星	眼冒星星 🤩
party	party 🥳
庆祝	庆祝 🥳 🎊 🎉
开party	开party 🥳
开淫趴	开淫趴 🥳
开趴	开趴 🥳
开银趴	开银趴 🥳
派对	派对 🥳 🎊 🎉
派对脸	派对脸 🥳
上下点头	上下点头 🙂‍↕
摇头晃脑	摇头晃脑 🙂‍↕ 🙂‍↔ 🫨
晃脑	晃脑 🙂‍↕ 🙂‍↔ 🫨
点头	点头 🙂‍↕
得意	得意 😏
得意地笑	得意地笑 😏
郁闷	郁闷 😒
鄙视	鄙视 😒
左右摇头	左右摇头 🙂‍↔
摇头	摇头 🙂‍↔ 🫨
猛摇头	猛摇头 🙂‍↔ 🫨
甩头	甩头 🙂‍↔ 🫨
失望	失望 😞
难过	难过 😞
低头忧伤	低头忧伤 😔
心事重重	心事重重 😔
忧伤	忧伤 😔
忧虑	忧虑 😔
担心	担心 😟
担忧	担忧 😟
不屑	不屑 😕
困扰	困扰 😕
一脸不悦	一脸不悦 🙁 ☹
不开心	不开心 🙁 ☹
不悦	不悦 🙁 ☹
不满	不满 🙁 ☹
不高兴	不高兴 🙁 ☹
微微不满	微微不满 🙁 ☹
心情不好	心情不好 🙁 ☹
皱眉	皱眉 🙁 ☹
忍耐	忍耐 😣
焦头烂额	焦头烂额 😖
纠结	纠结 😖
抓狂	抓狂 😫
焦虑	焦虑 😩 😰
焦躁	焦躁 😩
疲倦	疲倦 😩
疲劳	疲劳 😩
疲惫	疲惫 😩
可怜	可怜 🥺
可怜兮兮	可怜兮兮 🥺
好嘛	好嘛 🥺
求你了	求你了 🥺 🙏
求求你	求求你 🥺 🙏
求求你了	求求你了 🥺 🙏
哭	哭 😢 😭
哭了	哭了 😢 😭
哭泣	哭泣 😢 😭
流泪	流泪 😢 😭
流眼泪	流眼泪 😢 😭
大哭	大哭 😭
放声大哭	放声大哭 😭
痛哭	痛哭 😭
傲慢	傲慢 😤
哼	哼 😤
哼哼	哼哼 😤
趾高气昂	趾高气昂 😤
鼻子冒气	鼻子冒气 😤
angry	angry 😠 😡 💢
微怒	微怒 😠
怒	怒 😠 😡 💢
愤怒	愤怒 😠 😡 💢
气人	气人 😠 😡
生气	生气 😠 😡 💢
发火	发火 😡
发飙	发飙 😡
怒火中烧	怒火中烧 😡
烦死	烦死 😡
烦死了	烦死了 😡
烦死人	烦死人 😡
烦死啦	烦死啦 😡
NMSL	NMSL 🤬
你妈死了	你妈死了 🤬
傻逼	傻逼 🤬
出口成脏	出口成脏 🤬
咒骂	咒骂 🤬
操你妈	操你妈 🤬
肏你妈	肏你妈 🤬
脏话	脏话 🤬
说脏话	说脏话 🤬
骂人	骂人 🤬
大脑爆炸	大脑爆炸 🤯
头爆炸	头爆炸 🤯
爆头	爆头 🤯
爆炸头	爆炸头 🤯
爆炸脑	爆炸脑 🤯
脑子爆炸	脑子爆炸 🤯
脑爆炸	脑爆炸 🤯
脑袋爆炸	脑袋爆炸 🤯
害羞	害羞 😳
愣住	愣住 😳
羞涩	羞涩 😳
发热	发热 🥵
好热	好热 🥵
很热	很热 🥵
热	热 🥵
热死	热死 🥵
热死了	热死了 🥵
爆辣	爆辣 🥵
脸发烧	脸发烧 🥵
超级辣	超级辣 🥵
超辣	超辣 🥵
辣	辣 🥵
辣死	辣死 🥵
辣死了	辣死了 🥵
冰冷	冰冷 🥶
冷	冷 🥶
冷冰冰	冷冰冰 🥶
冷死	冷死 🥶
冷死了	冷死了 🥶
冷脸	冷脸 🥶
冻僵	冻僵 🥶
冻僵了	冻僵了 🥶
冻死	冻死 🥶
冻死了	冻死了 🥶
好冷	好冷 🥶
很冷	很冷 🥶
满面寒霜	满面寒霜 🥶
云中	云中 😶‍🌫️
云中的脸	云中的脸 😶‍🌫️
迷茫	迷茫 😶‍🌫️
可怕	可怕 😱 😨
吓人	吓人 😱
吓死	吓死 😱
吓死了	吓死了 😱
害怕	害怕 😱 😨
尖叫	尖叫 😱
怕	怕 😱 😨
恐怖	恐怖 😱
恐惧	恐惧 😱 😨
恐惧尖叫	恐惧尖叫 😱
惊声尖叫	惊声尖叫 😱
冒汗焦虑	冒汗焦虑 😰
紧张	紧张 😰
失望但如释重负	失望但如释重负 😥
难过但释然	难过但释然 😥
倒霉	倒霉 😓
沮丧	沮丧 😓
抱抱	抱抱 🤗 🫂
拥抱	拥抱 🤗 🫂
不明白	不明白 🤔
不理解	不理解 🤔
可能	可能 🤔
呃	呃 🤔
奇怪	奇怪 🤔
奇怪了	奇怪了 🤔
容我三思	容我三思 🤔
思考	思考 🤔
想一想	想一想 🤔
想想	想想 🤔
我再想想	我再想想 🤔
我想想	我想想 🤔
深思	深思 🤔
深思的脸	深思的脸 🤔
疑惑	疑惑 🤔
疑问	疑问 🤔
不敢看	不敢看 🫣
偷偷看	偷偷看 🫣
偷偷瞧	偷偷瞧 🫣
偷看	偷看 🫣
偷瞧	偷瞧 🫣
单眼偷看	单眼偷看 🫣
我不敢看	我不敢看 🫣
画面太美我不敢看	画面太美我不敢看 🫣
那画面太美我不敢看	那画面太美我不敢看 🫣
好笑	好笑 🤭
捂上嘴巴	捂上嘴巴 🤭 🙊
捂住嘴巴	捂住嘴巴 🤭 🙊
捂嘴	捂嘴 🤭 🙊
捂嘴巴	捂嘴巴 🤭 🙊
捂嘴笑	捂嘴笑 🤭
捂着嘴巴	捂着嘴巴 🤭 🙊
捂着嘴笑	捂着嘴笑 🤭
unbelievable	unbelievable 🫢
不可置信	不可置信 🫢
不敢相信	不敢相信 🫢
难以相信	难以相信 🫢
难以置信	难以置信 🫢
respect	respect 🫡
尊敬	尊敬 🫡
尊重	尊重 🫡
敬礼	敬礼 🫡
瑞思拜	瑞思拜 🫡
致敬	致敬 🫡
别说话	别说话 🤫
嘘	嘘 🤫
安静	安静 🤫
安静的脸	安静的脸 🤫
小声	小声 🤫
小声点	小声点 🤫
小点声	小点声 🤫
消失	消失 🫠 🫥
溶解	溶解 🫠
融化	融化 🫠
乌索普	乌索普 🤥
乱讲	乱讲 🤥
匹诺曹	匹诺曹 🤥
撒谎	撒谎 🤥
胡说	胡说 🤥
说谎	说谎 🤥
长鼻	长鼻 🤥
长鼻子	长鼻子 🤥
骗人	骗人 🤥
骗人布	骗人布 🤥
骗子	骗子 🤥
沉默	沉默 😶
没嘴	没嘴 😶
没有嘴	没有嘴 😶
没有嘴巴	没有嘴巴 😶
虚线脸	虚线脸 🫥
虚线轮廓	虚线轮廓 🫥
隐形	隐形 🫥
隐藏	隐藏 🫥
平静	平静 😐
不确定	不确定 🫤
撇嘴	撇嘴 🫤
面无表情	面无表情 😑
颤抖的脸	颤抖的脸 🫨
咬牙	咬牙 😬
咬牙切齿	咬牙切齿 😬
龇牙	龇牙 😬
龇牙咧嘴	龇牙咧嘴 😬
白眼	白眼 🙄
翻白眼	翻白眼 🙄
吃惊	吃惊 😯 😦 😧 😮 😲
好奇	好奇 😯
惊讶	惊讶 😯 😦 😧 😮 😲
啊	啊 😦 😧 😲
目瞪口呆	目瞪口呆 😦
震惊	震惊 😦 😧 😲
哦	哦 😮
呵欠	呵欠 🥱
哈欠	哈欠 🥱
困	困 🥱 😪
困了	困了 🥱 😪
困倦	困倦 🥱 😪
打呵欠	打呵欠 🥱
打哈欠	打哈欠 🥱
睡了	睡了 😴 💤
睡眠	睡眠 😴 💤
睡着	睡着 😴 💤
睡着了	睡着了 😴 💤
睡觉	睡觉 😴 🛌 💤
口水	口水 🤤
垂涎三尺	垂涎三尺 🤤
流口水	流口水 🤤
困乏	困乏 😪
困困	困困 😪
打瞌睡	打瞌睡 😪
瞌睡	瞌睡 😪
叹气	叹气 😮‍💨
呼气	呼气 😮‍💨 🫁
唉	唉 😮‍💨
无奈	无奈 😮‍💨
头晕	头晕 😵 😵‍💫
头晕目眩	头晕目眩 😵 😵‍💫 💫
头晕眼花	头晕眼花 😵 😵‍💫
我晕	我晕 😵 😵‍💫
晕	晕 😵 😵‍💫
晕了	晕了 😵 😵‍💫
晕头	晕头 😵 😵‍💫
晕头转向	晕头转向 😵 😵‍💫
不能说	不能说 🤐
不要说	不要说 🤐
不说	不说 🤐 🙊
保密	保密 🤐
守密	守密 🤐
封口	封口 🤐
拉上拉链	拉上拉链 🤐
禁言	禁言 🤐
秘密	秘密 🤐 ㊙️
闭嘴	闭嘴 🤐
喝多	喝多 🥴
喝多了	喝多了 🥴
喝醉	喝醉 🥴
喝醉了	喝醉了 🥴
微醺	微醺 🥴
昏昏沉沉	昏昏沉沉 🥴
酒醉	酒醉 🥴
醉了	醉了 🥴
反胃	反胃 🤢
恶心	恶心 🤢
想吐	想吐 🤢
吐	吐 🤮
吐了	吐了 🤮
吐出来	吐出来 🤮
呕吐	呕吐 🤮
喷嚏	喷嚏 🤧
感冒	感冒 🤧 😷
打喷嚏	打喷嚏 🤧
擤鼻子	擤鼻子 🤧
擤鼻涕	擤鼻涕 🤧
鼻涕	鼻涕 🤧
鼻炎	鼻炎 🤧
口罩	口罩 😷
戴口罩	戴口罩 😷
生病	生病 😷
体温计	体温计 🤒
发烧	发烧 🤒
量体温	量体温 🤒
受伤	受伤 🤕 ❤️‍🩹
绷带	绷带 🤕
缠满绷带	缠满绷带 🤕
缠绷带	缠绷带 🤕
负伤	负伤 🤕
发财	发财 🤑
拜金	拜金 🤑
见钱眼开	见钱眼开 🤑
财迷	财迷 🤑
钱眼	钱眼 🤑
牛仔	牛仔 🤠
牛仔帽	牛仔帽 🤠
牛仔帽脸	牛仔帽脸 🤠
微笑恶魔	微笑恶魔 😈
微笑的恶魔	微笑的恶魔 😈
恶魔	恶魔 😈 👿
恶魔微笑	恶魔微笑 😈
魔鬼	魔鬼 😈 👿
恶魔生气	恶魔生气 👿
生气恶魔	生气恶魔 👿
生气的恶魔	生气的恶魔 👿
妖怪	妖怪 👹 👺
怪物	怪物 👹 👺
小丑	小丑 🤡
小丑脸	小丑脸 🤡
便便	便便 💩
大便	大便 💩
屎	屎 💩
拉便便	拉便便 💩
拉大便	拉大便 💩
拉屎	拉屎 💩
拉粑粑	拉粑粑 💩
粑粑	粑粑 💩
幽灵	幽灵 👻
鬼	鬼 👻
鬼脸	鬼脸 👻
鬼魂	鬼魂 👻
头骨	头骨 💀 ☠️
死亡	死亡 💀 ☠️
骷髅	骷髅 💀 ☠️
骷髅头	骷髅头 💀 ☠️
外星人	外星人 👽
外星怪物	外星怪物 👾
异形怪兽	异形怪兽 👾
怪兽	怪兽 👾
机器人	机器人 🤖
万圣节	万圣节 🎃
南瓜头	南瓜头 🎃
南瓜灯	南瓜灯 🎃
南瓜灯笼	南瓜灯笼 🎃
开心猫	开心猫 😺
开心猫脸	开心猫脸 😺
开心的猫	开心的猫 😺
微笑猫	微笑猫 😸
微笑猫脸	微笑猫脸 😸
微笑的猫	微笑的猫 😸
喜极而泣	喜极而泣 😹
笑中带泪	笑中带泪 😹
笑出眼泪的猫	笑出眼泪的猫 😹
花痴猫	花痴猫 😻
花痴猫脸	花痴猫脸 😻
花痴的猫	花痴的猫 😻
得意猫	得意猫 😼
得意猫脸	得意猫脸 😼
得意的猫	得意的猫 😼
亲亲猫	亲亲猫 😽
亲亲猫脸	亲亲猫脸 😽
亲亲的猫	亲亲的猫 😽
害怕猫	害怕猫 🙀
害怕猫脸	害怕猫脸 🙀
害怕的猫	害怕的猫 🙀
恐惧猫	恐惧猫 🙀
恐惧猫脸	恐惧猫脸 🙀
恐惧的猫	恐惧的猫 🙀
哭泣猫	哭泣猫 😿
哭泣猫脸	哭泣猫脸 😿
哭泣的猫	哭泣的猫 😿
噘嘴猫	噘嘴猫 😾
噘嘴猫脸	噘嘴猫脸 😾
噘嘴的猫	噘嘴的猫 😾
生气猫	生气猫 😾
生气猫脸	生气猫脸 😾
生气的猫	生气的猫 😾
做成心形的双手	做成心形的双手 🫶
比心	比心 🫶 🫰
比心手势	比心手势 🫶 🫰
双手	双手 🤲
双手手掌向上	双手手掌向上 🤲
捧着	捧着 🤲
掌心向上托起	掌心向上托起 🤲
双手张开	双手张开 👐
张开双手	张开双手 👐
举双手	举双手 🙌
扬手欢呼	扬手欢呼 🙌
啪啪啪	啪啪啪 👏
拍手	拍手 👏
拍掌	拍掌 👏
鼓掌	鼓掌 👏
合作	合作 🤝
合作愉快	合作愉快 🤝
握手	握手 🤝
搞定	搞定 🤝
不错	不错 👍
厉害	厉害 👍
大拇指	大拇指 👍 👎
大拇指向上	大拇指向上 👍
大拇指朝上	大拇指朝上 👍
太棒	太棒 👍
太棒了	太棒了 👍
太棒啦	太棒啦 👍
好强	好强 👍
好棒	好棒 👍
干得好	干得好 👍
强	强 👍
很好	很好 👍
很棒	很棒 👍
拇指	拇指 👍 👎
拇指向上	拇指向上 👍
拇指朝上	拇指朝上 👍
棒	棒 👍
棒啊	棒啊 👍
棒棒	棒棒 👍
棒棒哒	棒棒哒 👍
棒棒的	棒棒的 👍
点赞	点赞 👍
牛逼	牛逼 👍
特棒	特棒 👍
真棒	真棒 👍
绝了	绝了 👍
表扬	表扬 👍
赞	赞 👍
非常棒	非常棒 👍
不好	不好 👎
不强	不强 👎
不棒	不棒 👎
大拇指向下	大拇指向下 👎
大拇指朝下	大拇指朝下 👎
太差	太差 👎
太差了	太差了 👎
太差啦	太差啦 👎
差劲	差劲 👎
很差	很差 👎
拇指朝下	拇指朝下 👎
出拳	出拳 👊
干你	干你 👊
打你	打你 👊
打击	打击 👊
拳头	拳头 👊
揍你	揍你 👊
握紧的拳头	握紧的拳头 👊
重拳出击	重拳出击 👊
举起拳头	举起拳头 ✊
举起的拳头	举起的拳头 ✊
握拳	握拳 ✊
右拳	右拳 🤛
右钩拳	右钩拳 🤛
左向拳	左向拳 🤛
朝左的拳头	朝左的拳头 🤛
右向拳	右向拳 🤜
左拳	左拳 🤜
左钩拳	左钩拳 🤜
朝右的拳头	朝右的拳头 🤜
向左推	向左推 🫷
向左推手	向左推手 🫷
向左推的手	向左推的手 🫷
左手	左手 🫷 🫲
左推	左推 🫷
推手	推手 🫷 🫸
右手	右手 🫸 🫱
右推	右推 🫸
向右推	向右推 🫸
向右推手	向右推手 🫸
向右推的手	向右推的手 🫸
交叉的手指	交叉的手指 🤞
手指交叉	手指交叉 🤞
两个	两个 ✌️
剪刀手	剪刀手 ✌️
和平手势	和平手势 ✌️
哦耶	哦耶 ✌️
成功	成功 ✌️
第二	第二 ✌️
耶	耶 ✌️
胜利	胜利 ✌️
赢了	赢了 ✌️
赢咯	赢咯 ✌️
赢啦	赢啦 ✌️
响指	响指 🫰
打响指	打响指 🫰
食指和拇指交叉的手	食指和拇指交叉的手 🫰
我爱你	我爱你 🤟
爱你	爱你 🤟
爱你手势	爱你手势 🤟
爱你的手势	爱你的手势 🤟
摇滚	摇滚 🤘
摇滚手势	摇滚手势 🤘
金属礼	金属礼 🤘
OK	OK 👌 🙆‍♀️ 🙆 🙆‍♂️ 🆗
好	好 👌 🙆‍♀️ 🙆 🙆‍♂️ 🙂‍↕
好哒	好哒 👌
好的	好的 👌 🙆‍♀️ 🙆 🙆‍♂️
没问题	没问题 👌
兰花指	兰花指 🤌
手指	手指 🤌
手指捏和	手指捏和 🤌
捏合	捏合 🤌
捏手指	捏手指 🤌
一点	一点 🤏 🕐
一点点	一点点 🤏
少许	少许 🤏
少量	少量 🤏
手掌朝下	手掌朝下 🫳
掌心朝下	掌心朝下 🫳
放手	放手 🫳
朝下	朝下 🫳
伸手	伸手 🫴
手掌朝上	手掌朝上 🫴
抬起	抬起 🫴
掌心朝上	掌心朝上 🫴
朝上	朝上 🫴
反手食指向左指	反手食指向左指 👈
向左	向左 👈
向左指	向左指 👈
左边	左边 👈
左面	左面 👈
往左	往左 👈
往左指	往左指 👈
反手食指向右指	反手食指向右指 👉
右边	右边 👉
右面	右面 👉
向右	向右 👉
向右指	向右指 👉
往右	往右 👉
往右指	往右指 👉
上边	上边 👆
上面	上面 👆
反手食指向上指	反手食指向上指 👆
向上	向上 👆
向上指	向上指 👆
往上	往上 👆
往上指	往上指 👆
下边	下边 👇
下面	下面 👇
反手食指向下指	反手食指向下指 👇
向下	向下 👇
向下指	向下指 👇
往下	往下 👇
往下指	往下指 👇
一个	一个 ☝️
第一	第一 ☝️
食指	食指 ☝️
举起的手	举起的手 ✋
击掌	击掌 ✋
手	手 ✋
手掌	手掌 ✋
手背	手背 🤚
张开手指	张开手指 🖐
张开手指的手	张开手指的手 🖐
手指张开	手指张开 🖐
手指张开的手	手指张开的手 🖐
斯波克	斯波克 🖖
星际迷航	星际迷航 🖖
瓦肯	瓦肯 🖖
瓦肯举手礼	瓦肯举手礼 🖖
你好	你好 👋
再见	再见 👋
拜拜	拜拜 👋
挥手	挥手 👋
摆手	摆手 👋
六六六	六六六 🤙
回电话	回电话 🤙
打电话	打电话 🤙
打电话给我	打电话给我 🤙
打给我	打给我 🤙
给我打电话	给我打电话 🤙
向左伸的手	向左伸的手 🫲
向左的手	向左的手 🫲
朝左	朝左 🫲
向右伸的手	向右伸的手 🫱
向右的手	向右的手 🫱
朝右	朝右 🫱
二头肌	二头肌 💪
健身	健身 💪
加油	加油 💪 ⛽
努力	努力 💪
奋斗	奋斗 💪
强壮	强壮 💪
秀肌肉	秀肌肉 💪
肌肉	肌肉 💪
肱二头	肱二头 💪
肱二头肌	肱二头肌 💪
义体	义体 🦾 🦿
义肢	义肢 🦾 🦿
机械手臂	机械手臂 🦾
机械臂	机械臂 🦾
赛博朋克	赛博朋克 🦾 🦿
中指	中指 🖕
举中指	举中指 🖕
比中指	比中指 🖕
竖中指	竖中指 🖕
写字	写字 ✍️
手写	手写 ✍️
双手合十	双手合十 🙏
合十	合十 🙏
合掌	合掌 🙏
感谢	感谢 🙏
拜托	拜托 🙏
祈求	祈求 🙏
祈祷	祈祷 🙏
谢谢	谢谢 🙏
超度	超度 🙏
阿弥陀佛	阿弥陀佛 🙏
你自己	你自己 🫵
就是你	就是你 🫵
指人	指人 🫵
指你	指你 🫵
指向观察者的食指	指向观察者的食指 🫵
指我	指我 🫵
指着	指着 🫵
指着你	指着你 🫵
食指指向观察者	食指指向观察者 🫵
脚	脚 🦶
脚丫	脚丫 🦶
脚丫子	脚丫子 🦶
足	足 🦶
踢	踢 🦶
踩	踩 🦶
大腿	大腿 🦵
练腿	练腿 🦵
腿	腿 🦵
机械腿	机械腿 🦿
口红	口红 💄
唇膏	唇膏 💄
kiss	kiss 💋
么么	么么 💋
么么哒	么么哒 💋
亲	亲 💋
亲吻	亲吻 💋
亲嘴	亲嘴 💋
吻	吻 💋
吻痕	吻痕 💋
唇	唇 💋 👄
唇印	唇印 💋
红唇	红唇 💋 👄
口	口 👄
嘴	嘴 👄
嘴唇	嘴唇 👄
嘴巴	嘴巴 👄
咬住嘴唇	咬住嘴唇 🫦
咬嘴唇	咬嘴唇 🫦
情调	情调 🫦
诱惑	诱惑 🫦
调情	调情 🫦
牙	牙 🦷
牙牙	牙牙 🦷
牙齿	牙齿 🦷
舌	舌 👅
舌头	舌头 👅
听	听 👂
耳	耳 👂
耳朵	耳朵 👂
助听器	助听器 🦻
听力障碍	听力障碍 🦻
戴助听器的耳朵	戴助听器的耳朵 🦻
呼吸	呼吸 👃
嗅	嗅 👃
闻	闻 👃
鼻	鼻 👃
鼻子	鼻子 👃
脚印	脚印 👣
足迹	足迹 👣
一只眼	一只眼 👁
一只眼睛	一只眼睛 👁
单眼	单眼 👁
眼	眼 👁 👀
眼睛	眼睛 👁 👀
瞳孔	瞳孔 👁
注视	注视 👀
看	看 👀
看看	看看 👀
观察	观察 👀
心脏	心脏 🫀
心脏器官	心脏器官 🫀
吸气	吸气 🫁
呼吸作用	呼吸作用 🫁
肺	肺 🫁
大脑	大脑 🧠
头脑	头脑 🧠
脑	脑 🧠
脑子	脑子 🧠
脑花	脑花 🧠
剪影	剪影 🗣 👤 👥 🫂
头部剪影	头部剪影 🗣
讲话	讲话 🗣
讲话者	讲话者 🗣
讲话者的头部剪影	讲话者的头部剪影 🗣
人物剪影	人物剪影 👤
半身像	半身像 👤 👥
头像	头像 👤
双人	双人 👥
双人像	双人像 👥
抱在一起	抱在一起 🫂
拥抱的人	拥抱的人 🫂
baby	baby 👶 🚼
乖宝	乖宝 👶
乖宝宝	乖宝宝 👶
婴儿	婴儿 👶 🚼
宝宝	宝宝 👶 🚼
小宝贝	小宝贝 👶
女儿	女儿 👧
女孩	女孩 👧
小女孩	小女孩 👧
儿童	儿童 🧒
孩子	孩子 🧒
小孩	小孩 🧒
小孩子	小孩子 🧒
小朋友	小朋友 🧒
儿子	儿子 👦
男孩	男孩 👦
小男孩	小男孩 👦
女人	女人 👩 🧑
妈妈	妈妈 👩 🧑
母亲	母亲 👩 🧑
老妈	老妈 👩 🧑
成年女人	成年女人 👩 🧑
成年女性	成年女性 👩 🧑
男人	男人 👨
爸爸	爸爸 👨
父亲	父亲 👨
老爹	老爹 👨
成年男人	成年男人 👨
成年男性	成年男性 👨
卷发	卷发 👩‍🦱 🧑‍🦱 👨‍🦱 🦱
卷发女	卷发女 👩‍🦱 🧑‍🦱
卷发女人	卷发女人 👩‍🦱 🧑‍🦱
卷发女子	卷发女子 👩‍🦱 🧑‍🦱
卷发男	卷发男 👨‍🦱
卷发男人	卷发男人 👨‍🦱
卷发男子	卷发男子 👨‍🦱
赤发	赤发 👩‍🦰 🧑‍🦰 👨‍🦰 🦰
红发	红发 👩‍🦰 🧑‍🦰 👨‍🦰 🦰
红头发	红头发 👩‍🦰 🧑‍🦰 👨‍🦰 🦰
红色头发	红色头发 👩‍🦰 🧑‍🦰 👨‍🦰 🦰
红发女	红发女 👩‍🦰 🧑‍🦰
红发女人	红发女人 👩‍🦰 🧑‍🦰
红发女子	红发女子 👩‍🦰 🧑‍🦰
红发男	红发男 👨‍🦰
红发男人	红发男人 👨‍🦰
红发男子	红发男子 👨‍🦰
金发	金发 👱‍♀️ 👱 👱‍♂️
金色头发	金色头发 👱‍♀️ 👱 👱‍♂️
金发女	金发女 👱‍♀️ 👱
金发女人	金发女人 👱‍♀️ 👱
金发女子	金发女子 👱‍♀️ 👱
金发男	金发男 👱‍♂️
金发男人	金发男人 👱‍♂️
金发男子	金发男子 👱‍♂️
白发	白发 👩‍🦳 🧑‍🦳 👨‍🦳 🦳
白色头发	白色头发 👩‍🦳 🧑‍🦳 👨‍🦳 🦳
白发女	白发女 👩‍🦳 🧑‍🦳
白发女人	白发女人 👩‍🦳 🧑‍🦳
白发女子	白发女子 👩‍🦳 🧑‍🦳
白发男	白发男 👨‍🦳
白发男人	白发男人 👨‍🦳
白发男子	白发男子 👨‍🦳
光头	光头 👩‍🦲 🧑‍🦲 👨‍🦲 🦲
头秃	头秃 👩‍🦲 🧑‍🦲 👨‍🦲 🦲
秃头	秃头 👩‍🦲 🧑‍🦲 👨‍🦲 🦲
秃顶	秃顶 👩‍🦲 🧑‍🦲 👨‍🦲 🦲
脱发	脱发 👩‍🦲 🧑‍🦲 👨‍🦲 🦲
光头女	光头女 👩‍🦲 🧑‍🦲
光头女人	光头女人 👩‍🦲 🧑‍🦲
光头女子	光头女子 👩‍🦲 🧑‍🦲
尼姑	尼姑 👩‍🦲 🧑‍🦲
光头男	光头男 👨‍🦲
光头男人	光头男人 👨‍🦲
光头男子	光头男子 👨‍🦲
和尚	和尚 👨‍🦲
胡子女	胡子女 🧔‍♀️ 🧔
有胡子的女人	有胡子的女人 🧔‍♀️ 🧔
有胡须的女人	有胡须的女人 🧔‍♀️ 🧔
长胡子的女人	长胡子的女人 🧔‍♀️ 🧔
长胡须的女人	长胡须的女人 🧔‍♀️ 🧔
络腮胡	络腮胡 🧔‍♂️
大叔	大叔 🧔‍♂️
胡子	胡子 🧔‍♂️
胡须	胡须 🧔‍♂️
有胡子的人	有胡子的人 🧔‍♂️
有胡须的人	有胡须的人 🧔‍♂️
长胡子的人	长胡子的人 🧔‍♂️
长胡须的人	长胡须的人 🧔‍♂️
老人	老人 👵 🧓 👴
外婆	外婆 👵 🧓
奶奶	奶奶 👵 🧓
姥姥	姥姥 👵 🧓
祖母	祖母 👵 🧓
老太太	老太太 👵 🧓
老奶奶	老奶奶 👵 🧓
外公	外公 👴
姥爷	姥爷 👴
爷爷	爷爷 👴
祖父	祖父 👴
老头	老头 👴
老爷爷	老爷爷 👴
中国帽	中国帽 👲
瓜皮帽	瓜皮帽 👲
地主	地主 👲
头巾	头巾 👳‍♀️ 👳 👳‍♂️ 🧕
戴头巾	戴头巾 👳‍♀️ 👳 👳‍♂️
戴头巾的人	戴头巾的人 👳‍♀️ 👳 👳‍♂️
穆斯林	穆斯林 🧕
警官	警官 👮‍♀️ 👮 👮‍♂️
女警官	女警官 👮‍♀️ 👮
男警官	男警官 👮‍♂️
警察	警察 👮‍♀️ 👮 👮‍♂️
女警察	女警察 👮‍♀️ 👮
男警察	男警察 👮‍♂️
农民工	农民工 👷‍♀️ 👷 👷‍♂️
女农民工	女农民工 👷‍♀️ 👷
男农民工	男农民工 👷‍♂️
工人	工人 👷‍♀️ 👷 👷‍♂️
女工人	女工人 👷‍♀️ 👷
男工人	男工人 👷‍♂️
建筑工	建筑工 👷‍♀️ 👷 👷‍♂️
女建筑工	女建筑工 👷‍♀️ 👷
男建筑工	男建筑工 👷‍♂️
建筑工人	建筑工人 👷‍♀️ 👷 👷‍♂️
女建筑工人	女建筑工人 👷‍♀️ 👷
男建筑工人	男建筑工人 👷‍♂️
卫兵	卫兵 💂‍♀️ 💂 💂‍♂️
女卫兵	女卫兵 💂‍♀️ 💂
男卫兵	男卫兵 💂‍♂️
卫士	卫士 💂‍♀️ 💂 💂‍♂️
女卫士	女卫士 💂‍♀️ 💂
男卫士	男卫士 💂‍♂️
侦探	侦探 🕵️‍♀️ 🕵 🕵️‍♂️
女侦探	女侦探 🕵️‍♀️ 🕵
男侦探	男侦探 🕵️‍♂️
医护人员	医护人员 👩‍⚕️ 🧑‍⚕ 👨‍⚕️
女医护人员	女医护人员 👩‍⚕️ 🧑‍⚕
男医护人员	男医护人员 👨‍⚕️
医生	医生 👩‍⚕️ 🧑‍⚕ 👨‍⚕️
女医生	女医生 👩‍⚕️ 🧑‍⚕
男医生	男医生 👨‍⚕️
大夫	大夫 👩‍⚕️ 🧑‍⚕ 👨‍⚕️
女大夫	女大夫 👩‍⚕️ 🧑‍⚕
男大夫	男大夫 👨‍⚕️
农民	农民 👩‍🌾 🧑‍🌾 👨‍🌾
农妇	农妇 👩‍🌾 🧑‍🌾
农夫	农夫 👨‍🌾
下厨	下厨 👩‍🍳 🧑‍🍳 👨‍🍳
做饭	做饭 👩‍🍳 🧑‍🍳 👨‍🍳
大厨	大厨 👩‍🍳 🧑‍🍳 👨‍🍳
厨师	厨师 👩‍🍳 🧑‍🍳 👨‍🍳
女厨师	女厨师 👩‍🍳 🧑‍🍳
男厨师	男厨师 👨‍🍳
大学生	大学生 👩‍🎓 🧑‍🎓 👨‍🎓
本科生	本科生 👩‍🎓 🧑‍🎓 👨‍🎓
毕业	毕业 👩‍🎓 🧑‍🎓 👨‍🎓
学生	学生 👩‍🎓 🧑‍🎓 👨‍🎓
女学生	女学生 👩‍🎓 🧑‍🎓
男学生	男学生 👨‍🎓
摇滚歌手	摇滚歌手 👩‍🎤 🧑‍🎤 👨‍🎤
摇滚女歌手	摇滚女歌手 👩‍🎤 🧑‍🎤
女摇滚歌手	女摇滚歌手 👩‍🎤 🧑‍🎤
摇滚男歌手	摇滚男歌手 👨‍🎤
男摇滚歌手	男摇滚歌手 👨‍🎤
歌手	歌手 👩‍🎤 🧑‍🎤 👨‍🎤
女歌手	女歌手 👩‍🎤 🧑‍🎤
男歌手	男歌手 👨‍🎤
朋克	朋克 👩‍🎤 🧑‍🎤 👨‍🎤
重金属	重金属 👩‍🎤 🧑‍🎤 👨‍🎤
教师	教师 👩‍🏫 🧑‍🏫 👨‍🏫
女教师	女教师 👩‍🏫 🧑‍🏫
男教师	男教师 👨‍🏫
老师	老师 👩‍🏫 🧑‍🏫 👨‍🏫
女老师	女老师 👩‍🏫 🧑‍🏫
男老师	男老师 👨‍🏫
工厂工人	工厂工人 👩‍🏭 🧑‍🏭 👨‍🏭
女工厂工人	女工厂工人 👩‍🏭 🧑‍🏭
男工厂工人	男工厂工人 👨‍🏭
开发人员	开发人员 👩‍💻 🧑‍💻 👨‍💻
女开发人员	女开发人员 👩‍💻 🧑‍💻
男开发人员	男开发人员 👨‍💻
技术员	技术员 👩‍💻 🧑‍💻 👨‍💻
女技术员	女技术员 👩‍💻 🧑‍💻
男技术员	男技术员 👨‍💻
码农	码农 👩‍💻 🧑‍💻 👨‍💻
女码农	女码农 👩‍💻 🧑‍💻
男码农	男码农 👨‍💻
码畜	码畜 👩‍💻 🧑‍💻 👨‍💻
女码畜	女码畜 👩‍💻 🧑‍💻
男码畜	男码畜 👨‍💻
程序员	程序员 👩‍💻 🧑‍💻 👨‍💻
女程序员	女程序员 👩‍💻 🧑‍💻
男程序员	男程序员 👨‍💻
办公室职员	办公室职员 👩‍💼 🧑‍💼 👨‍💼
女办公室职员	女办公室职员 👩‍💼 🧑‍💼
男办公室职员	男办公室职员 👨‍💼
白领	白领 👩‍💼 🧑‍💼 👨‍💼
女白领	女白领 👩‍💼 🧑‍💼
男白领	男白领 👨‍💼
职员	职员 👩‍💼 🧑‍💼 👨‍💼
女职员	女职员 👩‍💼 🧑‍💼
男职员	男职员 👨‍💼
修理工	修理工 👩‍🔧 🧑‍🔧 👨‍🔧
女修理工	女修理工 👩‍🔧 🧑‍🔧
男修理工	男修理工 👨‍🔧
技工	技工 👩‍🔧 🧑‍🔧 👨‍🔧
女技工	女技工 👩‍🔧 🧑‍🔧
男技工	男技工 👨‍🔧
水管工	水管工 👩‍🔧 🧑‍🔧 👨‍🔧
女水管工	女水管工 👩‍🔧 🧑‍🔧
男水管工	男水管工 👨‍🔧
电工	电工 👩‍🔧 🧑‍🔧 👨‍🔧
女电工	女电工 👩‍🔧 🧑‍🔧
男电工	男电工 👨‍🔧
化学家	化学家 👩‍🔬 🧑‍🔬 👨‍🔬
女化学家	女化学家 👩‍🔬 🧑‍🔬
男化学家	男化学家 👨‍🔬
科学家	科学家 👩‍🔬 🧑‍🔬 👨‍🔬
女科学家	女科学家 👩‍🔬 🧑‍🔬
男科学家	男科学家 👨‍🔬
漫画家	漫画家 👩‍🎨 🧑‍🎨 👨‍🎨
女漫画家	女漫画家 👩‍🎨 🧑‍🎨
男漫画家	男漫画家 👨‍🎨
画家	画家 👩‍🎨 🧑‍🎨 👨‍🎨
女画家	女画家 👩‍🎨 🧑‍🎨
男画家	男画家 👨‍🎨
艺术家	艺术家 👩‍🎨 🧑‍🎨 👨‍🎨
女艺术家	女艺术家 👩‍🎨 🧑‍🎨
男艺术家	男艺术家 👨‍🎨
消防员	消防员 👩‍🚒 🧑‍🚒 👨‍🚒
女消防员	女消防员 👩‍🚒 🧑‍🚒
男消防员	男消防员 👨‍🚒
飞行员	飞行员 👩‍✈️ 🧑‍✈ 👨‍✈️
女飞行员	女飞行员 👩‍✈️ 🧑‍✈
男飞行员	男飞行员 👨‍✈️
宇航员	宇航员 👩‍🚀 🧑‍🚀 👨‍🚀
女宇航员	女宇航员 👩‍🚀 🧑‍🚀
男宇航员	男宇航员 👨‍🚀
法官	法官 👩‍⚖️ 🧑‍⚖ 👨‍⚖️
女法官	女法官 👩‍⚖️ 🧑‍⚖
男法官	男法官 👨‍⚖️
头纱	头纱 👰‍♀️ 👰
婚纱	婚纱 👰‍♀️ 👰
戴头纱的人	戴头纱的人 👰‍♀️ 👰
新娘	新娘 👰‍♀️ 👰
新娘子	新娘子 👰‍♀️ 👰
男新娘	男新娘 👰‍♂️
女新郎	女新郎 🤵‍♀️ 🤵
新郎	新郎 🤵‍♂️
燕尾服	燕尾服 🤵‍♂️
礼服	礼服 🤵‍♂️
西服	西服 🤵‍♂️
西装	西装 🤵‍♂️
君主	君主 👸 🫅 🤴
戴王冠的人	戴王冠的人 👸 🫅 🤴
小公主	小公主 👸 🫅
小王子	小王子 🤴
公主	公主 👸 🫅
王子	王子 🤴
女王	女王 👸 🫅
国王	国王 🤴
女皇	女皇 👸 🫅
忍者	忍者 🥷
忍术	忍术 🥷
超人	超人 🦸‍♀️ 🦸 🦸‍♂️
女超人	女超人 🦸‍♀️ 🦸
男超人	男超人 🦸‍♂️
超级英雄	超级英雄 🦸‍♀️ 🦸 🦸‍♂️
女超级英雄	女超级英雄 🦸‍♀️ 🦸
男超级英雄	男超级英雄 🦸‍♂️
反派	反派 🦹‍♀️ 🦹 🦹‍♂️
女反派	女反派 🦹‍♀️ 🦹
男反派	男反派 🦹‍♂️
坏蛋	坏蛋 🦹‍♀️ 🦹 🦹‍♂️
女坏蛋	女坏蛋 🦹‍♀️ 🦹
男坏蛋	男坏蛋 🦹‍♂️
大反派	大反派 🦹‍♀️ 🦹 🦹‍♂️
女大反派	女大反派 🦹‍♀️ 🦹
男大反派	男大反派 🦹‍♂️
超级大反派	超级大反派 🦹‍♀️ 🦹 🦹‍♂️
女超级大反派	女超级大反派 🦹‍♀️ 🦹
男超级大反派	男超级大反派 🦹‍♂️
圣诞夫人	圣诞夫人 🤶 🧑‍🎄
圣诞奶奶	圣诞奶奶 🤶 🧑‍🎄
圣诞老人	圣诞老人 🎅
法师	法师 🧙‍♀️ 🧙 🧙‍♂️
女法师	女法师 🧙‍♀️ 🧙
男法师	男法师 🧙‍♂️
魔术师	魔术师 🧙‍♀️ 🧙 🧙‍♂️
女魔术师	女魔术师 🧙‍♀️ 🧙
男魔术师	男魔术师 🧙‍♂️
魔法师	魔法师 🧙‍♀️ 🧙 🧙‍♂️
女魔法师	女魔法师 🧙‍♀️ 🧙
男魔法师	男魔法师 🧙‍♂️
女巫	女巫 🧙‍♀️ 🧙
男巫	男巫 🧙‍♂️
精灵	精灵 🧝‍♀️ 🧝 🧝‍♂️
女精灵	女精灵 🧝‍♀️ 🧝
男精灵	男精灵 🧝‍♂️
精灵族	精灵族 🧝‍♀️ 🧝 🧝‍♂️
巨怪	巨怪 🧌
穴居巨怪	穴居巨怪 🧌
德古拉	德古拉 🧛‍♀️ 🧛 🧛‍♂️
吸血鬼	吸血鬼 🧛‍♀️ 🧛 🧛‍♂️
女吸血鬼	女吸血鬼 🧛‍♀️ 🧛
男吸血鬼	男吸血鬼 🧛‍♂️
丧尸	丧尸 🧟‍♀️ 🧟 🧟‍♂️
女丧尸	女丧尸 🧟‍♀️ 🧟
男丧尸	男丧尸 🧟‍♂️
僵尸	僵尸 🧟‍♀️ 🧟 🧟‍♂️
女僵尸	女僵尸 🧟‍♀️ 🧟
男僵尸	男僵尸 🧟‍♂️
行尸走肉	行尸走肉 🧟‍♀️ 🧟 🧟‍♂️
女行尸走肉	女行尸走肉 🧟‍♀️ 🧟
男行尸走肉	男行尸走肉 🧟‍♂️
灯神	灯神 🧞‍♀️ 🧞 🧞‍♂️
女灯神	女灯神 🧞‍♀️ 🧞
男灯神	男灯神 🧞‍♂️
阿拉丁	阿拉丁 🧞‍♀️ 🧞 🧞‍♂️
阿拉丁神灯	阿拉丁神灯 🧞‍♀️ 🧞 🧞‍♂️
人鱼	人鱼 🧜‍♀️ 🧜 🧜‍♂️
美人鱼	美人鱼 🧜‍♀️ 🧜
男人鱼	男人鱼 🧜‍♂️
美男鱼	美男鱼 🧜‍♂️
海王	海王 🧜‍♂️
妖精	妖精 🧚‍♀️ 🧚 🧚‍♂️
小仙女	小仙女 🧚‍♀️ 🧚
小仙子	小仙子 🧚‍♀️ 🧚 🧚‍♂️
小精灵	小精灵 🧚‍♀️ 🧚 🧚‍♂️
天使	天使 👼
天使宝宝	天使宝宝 👼
小天使	小天使 👼
大肚子	大肚子 🤰 🫄 🫃
孕妇	孕妇 🤰 🫄
孕肚	孕肚 🤰 🫄
怀了	怀了 🤰 🫄
怀孕	怀孕 🤰 🫄
啤酒肚	啤酒肚 🫃
将军肚	将军肚 🫃
怀孕的男人	怀孕的男人 🫃
男人怀孕	男人怀孕 🫃
哺乳	哺乳 🤱 👩‍🍼 🧑‍🍼
喂奶	喂奶 🤱
母乳	母乳 🤱
母乳喂养	母乳喂养 🤱
哺乳的女人	哺乳的女人 👩‍🍼 🧑‍🍼
哺乳的男人	哺乳的男人 👨‍🍼
奶妈	奶妈 👩‍🍼 🧑‍🍼
奶爸	奶爸 👨‍🍼
不好意思	不好意思 🙇‍♀️ 🙇 🙇‍♂️
对不起	对不起 🙇‍♀️ 🙇 🙇‍♂️
跪求	跪求 🙇‍♀️ 🙇 🙇‍♂️
道歉	道歉 🙇‍♀️ 🙇 🙇‍♂️
鞠躬	鞠躬 🙇‍♀️ 🙇 🙇‍♂️
服务员	服务员 💁‍♀️ 💁 💁‍♂️
女服务员	女服务员 💁‍♀️ 💁
男服务员	男服务员 💁‍♂️
服务生	服务生 💁‍♀️ 💁 💁‍♂️
女服务生	女服务生 💁‍♀️ 💁
男服务生	男服务生 💁‍♂️
不	不 🙅‍♀️ 🙅 🙅‍♂️ 🙂‍↔
不可以	不可以 🙅‍♀️ 🙅 🙅‍♂️
不同意	不同意 🙅‍♀️ 🙅 🙅‍♂️ 🙂‍↔
不行	不行 🙅‍♀️ 🙅 🙅‍♂️
反对	反对 🙅‍♀️ 🙅 🙅‍♂️
打咩	打咩 🙅‍♀️ 🙅 🙅‍♂️
拒绝	拒绝 🙅‍♀️ 🙅 🙅‍♂️
禁止手势	禁止手势 🙅‍♀️ 🙅 🙅‍♂️
可以	可以 🙆‍♀️ 🙆 🙆‍♂️ 🉑
同意	同意 🙆‍♀️ 🙆 🙆‍♂️ 🙂‍↕
举手	举手 🙋‍♀️ 🙋 🙋‍♂️
我知道	我知道 🙋‍♀️ 🙋 🙋‍♂️
这个我知道	这个我知道 🙋‍♀️ 🙋 🙋‍♂️
失聪	失聪 🧏‍♀️ 🧏 🧏‍♂️
失聪者	失聪者 🧏‍♀️ 🧏 🧏‍♂️
耳聋	耳聋 🧏‍♀️ 🧏 🧏‍♂️
聋子	聋子 🧏‍♀️ 🧏 🧏‍♂️
我服了	我服了 🤦‍♀️ 🤦 🤦‍♂️
我服了你	我服了你 🤦‍♀️ 🤦 🤦‍♂️
我服了你了	我服了你了 🤦‍♀️ 🤦 🤦‍♂️
手掌捂脸	手掌捂脸 🤦‍♀️ 🤦 🤦‍♂️
扶额	扶额 🤦‍♀️ 🤦 🤦‍♂️
捂脸	捂脸 🤦‍♀️ 🤦 🤦‍♂️
服了	服了 🤦‍♀️ 🤦 🤦‍♂️
服了你了	服了你了 🤦‍♀️ 🤦 🤦‍♂️
不关心	不关心 🤷‍♀️ 🤷 🤷‍♂️
不知道	不知道 🤷‍♀️ 🤷 🤷‍♂️
与我无关	与我无关 🤷‍♀️ 🤷 🤷‍♂️
耸肩	耸肩 🤷‍♀️ 🤷 🤷‍♂️
谁知道	谁知道 🤷‍♀️ 🤷 🤷‍♂️
谁知道呢	谁知道呢 🤷‍♀️ 🤷 🤷‍♂️
噘嘴的人	噘嘴的人 🙎‍♀️ 🙎 🙎‍♂️
皱着眉头	皱着眉头 🙍‍♀️ 🙍 🙍‍♂️
皱着眉头的人	皱着眉头的人 🙍‍♀️ 🙍 🙍‍♂️
做造型	做造型 💇‍♀️ 💇 💇‍♂️
剪发	剪发 💇‍♀️ 💇 💇‍♂️
剪头	剪头 💇‍♀️ 💇 💇‍♂️
剪头发	剪头发 💇‍♀️ 💇 💇‍♂️
理发	理发 💇‍♀️ 💇 💇‍♂️
理头	理头 💇‍♀️ 💇 💇‍♂️
理头发	理头发 💇‍♀️ 💇 💇‍♂️
美容美发	美容美发 💇‍♀️ 💇 💇‍♂️
按摩	按摩 💆‍♀️ 💆 💆‍♂️
美容	美容 💆‍♀️ 💆 💆‍♂️
桑拿	桑拿 🧖‍♀️ 🧖 🧖‍♂️
蒸房	蒸房 🧖‍♀️ 🧖 🧖‍♂️
蒸房里的人	蒸房里的人 🧖‍♀️ 🧖 🧖‍♂️
蒸房里的女人	蒸房里的女人 🧖‍♀️ 🧖
蒸房里的男人	蒸房里的男人 🧖‍♂️
蒸桑拿	蒸桑拿 🧖‍♀️ 🧖 🧖‍♂️
做指甲	做指甲 💅
做美甲	做美甲 💅
指甲油	指甲油 💅
涂指甲油	涂指甲油 💅
美甲	美甲 💅
自拍	自拍 🤳
跳舞	跳舞 💃 🕺
舞者	舞者 🕺
舞女	舞女 💃
舞男	舞男 🕺
跳舞的女人	跳舞的女人 💃
跳舞的男人	跳舞的男人 🕺
兔耳朵	兔耳朵 👯‍♀️ 👯 👯‍♂️
兔女郎	兔女郎 👯‍♀️ 👯
兔先生	兔先生 👯‍♂️
浮在地面上的西装男	浮在地面上的西装男 🕴
手动轮椅	手动轮椅 👩‍🦽 🧑‍🦽 👨‍🦽 👩‍🦽‍➡ 🧑‍🦽‍➡ 👨‍🦽‍➡ 🦽
坐手动轮椅的人	坐手动轮椅的人 👩‍🦽 🧑‍🦽 👨‍🦽 👩‍🦽‍➡ 🧑‍🦽‍➡ 👨‍🦽‍➡
坐手动轮椅的女人	坐手动轮椅的女人 👩‍🦽 🧑‍🦽 👩‍🦽‍➡ 🧑‍🦽‍➡
坐手动轮椅的男人	坐手动轮椅的男人 👨‍🦽 👨‍🦽‍➡
电动轮椅	电动轮椅 👩‍🦼 🧑‍🦼 👨‍🦼 👩‍🦼‍➡ 🧑‍🦼‍➡ 👨‍🦼‍➡ 🦼
坐电动轮椅的人	坐电动轮椅的人 👩‍🦼 🧑‍🦼 👨‍🦼 👩‍🦼‍➡ 🧑‍🦼‍➡ 👨‍🦼‍➡
坐电动轮椅的女人	坐电动轮椅的女人 👩‍🦼 🧑‍🦼 👩‍🦼‍➡ 🧑‍🦼‍➡
坐电动轮椅的男人	坐电动轮椅的男人 👨‍🦼 👨‍🦼‍➡
徒步	徒步 🚶‍♀️ 🚶 🚶‍♂️ 🚶‍♀️‍➡ 🚶‍➡ 🚶‍♂️‍➡
行人	行人 🚶‍♀️ 🚶 🚶‍♂️ 🚶‍♀️‍➡ 🚶‍➡ 🚶‍♂️‍➡
行走	行走 🚶‍♀️ 🚶 🚶‍♂️ 🚶‍♀️‍➡ 🚶‍➡ 🚶‍♂️‍➡
走路	走路 🚶‍♀️ 🚶 🚶‍♂️ 🚶‍♀️‍➡ 🚶‍➡ 🚶‍♂️‍➡
拄盲杖的人	拄盲杖的人 👩‍🦯 🧑‍🦯 👨‍🦯 👩‍🦯‍➡ 🧑‍🦯‍➡ 👨‍🦯‍➡
拿着白手杖的人	拿着白手杖的人 👩‍🦯 🧑‍🦯 👨‍🦯 👩‍🦯‍➡ 🧑‍🦯‍➡ 👨‍🦯‍➡
下跪	下跪 🧎‍♀️ 🧎 🧎‍♂️ 🧎‍♀️‍➡ 🧎‍➡ 🧎‍♂️‍➡
跪坐	跪坐 🧎‍♀️ 🧎 🧎‍♂️ 🧎‍♀️‍➡ 🧎‍➡ 🧎‍♂️‍➡
跪着	跪着 🧎‍♀️ 🧎 🧎‍♂️ 🧎‍♀️‍➡ 🧎‍➡ 🧎‍♂️‍➡
跑步	跑步 🏃‍♀️ 🏃 🏃‍♂️ 🏃‍♀️‍➡ 🏃‍➡ 🏃‍♂️‍➡
跑步者	跑步者 🏃‍♀️ 🏃 🏃‍♂️ 🏃‍♀️‍➡ 🏃‍➡ 🏃‍♂️‍➡
马拉松	马拉松 🏃‍♀️ 🏃 🏃‍♂️ 🏃‍♀️‍➡ 🏃‍➡ 🏃‍♂️‍➡
站着	站着 🧍‍♀️ 🧍 🧍‍♂️
站立	站立 🧍‍♀️ 🧍 🧍‍♂️
站立者	站立者 🧍‍♀️ 🧍 🧍‍♂️
站立的女人	站立的女人 🧍‍♀️ 🧍
站立的男人	站立的男人 🧍‍♂️
女仔	女仔 🧍‍♀️ 🧍
男仔	男仔 🧍‍♂️
妹妹	妹妹 🧍‍♀️ 🧍
弟弟	弟弟 🧍‍♂️
姐姐	姐姐 🧍‍♀️ 🧍
哥哥	哥哥 🧍‍♂️
手拉手	手拉手 👫 👭 🧑‍🤝‍🧑 👬
牵手	牵手 👫 👭 🧑‍🤝‍🧑 👬
情侣	情侣 👫
手拉手的情侣	手拉手的情侣 👫
牵手的情侣	牵手的情侣 👫
两个牵手的女人	两个牵手的女人 👭 🧑‍🤝‍🧑
两个牵手的男人	两个牵手的男人 👬
两个女人	两个女人 👭 🧑‍🤝‍🧑
两个男人	两个男人 👬
闺蜜	闺蜜 👭 🧑‍🤝‍🧑
兄弟	兄弟 👬
基友	基友 👬
好兄弟	好兄弟 👬
好基友	好基友 👬
love	love 👩‍❤️‍👨 👩‍❤️‍💋‍👨 💕 💓 ♥️
恋爱	恋爱 👩‍❤️‍👨 👩‍❤️‍💋‍👨
爱情	爱情 👩‍❤️‍👨 👩‍❤️‍💋‍👨 💕 💓
相爱	相爱 👩‍❤️‍👨 👩‍❤️‍💋‍👨
谈恋爱	谈恋爱 👩‍❤️‍👨 👩‍❤️‍💋‍👨
同性恋	同性恋 👩‍❤️‍👩 💑 👨‍❤️‍👨 👩‍❤️‍💋‍👩 💏 👨‍❤️‍💋‍👨
女同性恋	女同性恋 👩‍❤️‍👩 💑 👩‍❤️‍💋‍👩 💏
男同性恋	男同性恋 👨‍❤️‍👨 👨‍❤️‍💋‍👨
女同	女同 👩‍❤️‍👩 💑 👩‍❤️‍💋‍👩 💏
男同	男同 👨‍❤️‍👨 👨‍❤️‍💋‍👨
拉拉	拉拉 👩‍❤️‍👩 💑 👩‍❤️‍💋‍👩 💏
玻璃	玻璃 👨‍❤️‍👨 👨‍❤️‍💋‍👨
打结	打结 🪢
绳子	绳子 🪢
绳结	绳结 🪢
毛线	毛线 🧶
毛线球	毛线球 🧶
纱线	纱线 🧶
线团	线团 🧶
线轴	线轴 🧵
绣花针	绣花针 🪡
缝纫针	缝纫针 🪡
针	针 🪡
外套	外套 🧥
夹克	夹克 🧥
夹克衫	夹克衫 🧥
实验室外衣	实验室外衣 🥼
白大褂	白大褂 🥼
安全背心	安全背心 🦺
救生衣	救生衣 🦺
女士衬衫	女士衬衫 👚
女衬衫	女衬衫 👚
女装	女装 👚
T恤	T恤 👕
T恤衫	T恤衫 👕
上衣	上衣 👕
恤衫	恤衫 👕
汗衫	汗衫 👕
男士衬衫	男士衬衫 👕
男衬衫	男衬衫 👕
短袖	短袖 👕
衬衫	衬衫 👕
牛仔裤	牛仔裤 👖
裤子	裤子 👖
三角裤	三角裤 🩲
内裤	内裤 🩲
底裤	底裤 🩲
四角裤	四角裤 🩳
短裤	短裤 🩳
衣服	衣服 👔
衬衫领带	衬衫领带 👔
领带	领带 👔
裙子	裙子 👗
连衣裙	连衣裙 👗
长裙	长裙 👗
三点式	三点式 👙
内衣	内衣 👙
比基尼	比基尼 👙
泳装	泳装 👙 🩱
泳衣	泳衣 🩱
连体泳衣	连体泳衣 🩱
和服	和服 👘
浴衣	浴衣 👘
纱丽	纱丽 🥻
人字拖	人字拖 🩴
凉鞋	凉鞋 🩴 👡
夹趾凉鞋	夹趾凉鞋 🩴
拖鞋	拖鞋 🩴
沙滩凉鞋	沙滩凉鞋 🩴
平底鞋	平底鞋 🥿
女鞋	女鞋 👠
高跟鞋	高跟鞋 👠
女式凉鞋	女式凉鞋 👡
高跟凉鞋	高跟凉鞋 👡
女靴	女靴 👢
长靴	长靴 👢
靴子	靴子 👢
高跟靴	高跟靴 👢
男鞋	男鞋 👞
皮鞋	皮鞋 👞
休闲鞋	休闲鞋 👟
板鞋	板鞋 👟
网球鞋	网球鞋 👟
跑鞋	跑鞋 👟
运动鞋	运动鞋 👟
鞋子	鞋子 👟
登山鞋	登山鞋 🥾
短袜	短袜 🧦
袜子	袜子 🧦
手套	手套 🧤
围巾	围巾 🧣
帽子	帽子 🎩
礼帽	礼帽 🎩
高帽	高帽 🎩
棒球帽	棒球帽 🧢
鸭舌帽	鸭舌帽 🧢
女帽	女帽 👒
宽檐帽	宽檐帽 👒
带蝴蝶结的帽子	带蝴蝶结的帽子 👒
四方帽	四方帽 🎓
学士帽	学士帽 🎓
毕业帽	毕业帽 🎓
十字头盔	十字头盔 ⛑️
十字安全帽	十字安全帽 ⛑️
安全帽	安全帽 ⛑️
白十字头盔	白十字头盔 ⛑️
白十字安全帽	白十字安全帽 ⛑️
军人	军人 🪖
军用头盔	军用头盔 🪖
军盔	军盔 🪖
头盔	头盔 🪖
王冠	王冠 👑
皇冠	皇冠 👑
皇族	皇族 👑
戒指	戒指 💍
星钻	星钻 💍
求婚戒	求婚戒 💍
订婚戒	订婚戒 💍
钻戒	钻戒 💍
手拿包	手拿包 👝
皮包	皮包 👝
荷包	荷包 👝
女士钱包	女士钱包 👛
钱包	钱包 👛
零钱包	零钱包 👛
包包	包包 👜
女包	女包 👜
手提包	手提包 👜
挎包	挎包 👜
上班	上班 💼
公事包	公事包 💼
公文包	公文包 💼
工作	工作 💼
书包	书包 🎒
双肩包	双肩包 🎒
背包	背包 🎒
背囊	背囊 🎒
行李	行李 🧳
行李箱	行李箱 🧳
眼镜	眼镜 👓 🕶️ 🥽
近视	近视 👓
近视眼	近视眼 👓
护目镜	护目镜 🥽
泳镜	泳镜 🥽
游泳镜	游泳镜 🥽
收起的伞	收起的伞 🌂
收起的雨伞	收起的雨伞 🌂
雨伞	雨伞 🌂 ☔ ☂️
Doge	Doge 🐶
狗	狗 🐶 🐕
狗仔	狗仔 🐶 🐕
狗头	狗头 🐶
狗脸	狗脸 🐶
喵	喵 🐱
喵喵	喵喵 🐱
喵喵叫	喵喵叫 🐱
喵喵喵	喵喵喵 🐱
猫	猫 🐱 🐈
小猫	小猫 🐱 🐈
小猫咪	小猫咪 🐱 🐈
猫咪	猫咪 🐱 🐈
猫头	猫头 🐱
猫脸	猫脸 🐱
老鼠	老鼠 🐭 🐁 🐀
老鼠头	老鼠头 🐭
老鼠脸	老鼠脸 🐭
耗子	耗子 🐭 🐁 🐀
鼠	鼠 🐭 🐁
鼠头	鼠头 🐭
鼠脸	鼠脸 🐭
仓鼠	仓鼠 🐹
仓鼠头	仓鼠头 🐹
仓鼠脸	仓鼠脸 🐹
兔	兔 🐰 🐇
兔头	兔头 🐰
兔子	兔子 🐰 🐇
兔子头	兔子头 🐰
兔子脸	兔子脸 🐰
兔脸	兔脸 🐰
狐狸	狐狸 🦊
狐狸偷	狐狸偷 🦊
狐狸脸	狐狸脸 🦊
熊	熊 🐻
小熊	小熊 🐻
熊头	熊头 🐻
熊脸	熊脸 🐻
panda	panda 🐼
国宝	国宝 🐼
大熊猫	大熊猫 🐼
熊猫	熊猫 🐼
熊猫人	熊猫人 🐼
熊猫头	熊猫头 🐼
熊猫脸	熊猫脸 🐼
猫熊	猫熊 🐼
胖达	胖达 🐼
北极熊	北极熊 🐻‍❄️
北极熊头	北极熊头 🐻‍❄️
北极熊脸	北极熊脸 🐻‍❄️
无尾熊	无尾熊 🐨
树袋熊	树袋熊 🐨
考拉	考拉 🐨
老虎	老虎 🐯 🐅
老虎头	老虎头 🐯
老虎脸	老虎脸 🐯
虎	虎 🐯 🐅
虎头	虎头 🐯
虎脸	虎脸 🐯
狮	狮 🦁
狮头	狮头 🦁
狮子	狮子 🦁
狮子头	狮子头 🦁
狮子脸	狮子脸 🦁
狮脸	狮脸 🦁
牛	牛 🐮 🐄
小牛	小牛 🐮
牛头	牛头 🐮
牛牛	牛牛 🐮
牛脸	牛脸 🐮
猪	猪 🐷 🐖
小猪	小猪 🐷
懒猪	懒猪 🐷
猪头	猪头 🐷
猪猪	猪猪 🐷 🐖
猪脸	猪脸 🐷
猪鼻	猪鼻 🐽
猪鼻子	猪鼻子 🐽
蛤	蛤 🐸
蛤蛤	蛤蛤 🐸
蛤蟆	蛤蟆 🐸
青蛙	青蛙 🐸
青蛙头	青蛙头 🐸
青蛙脸	青蛙脸 🐸
猴	猴 🐵 🐒
猴头	猴头 🐵
猴脸	猴脸 🐵
不看	不看 🙈
我不看	我不看 🙈
蒙住眼睛	蒙住眼睛 🙈
蒙眼	蒙眼 🙈
蒙眼睛	蒙眼睛 🙈
非礼勿视	非礼勿视 🙈
不听	不听 🙉
堵上耳朵	堵上耳朵 🙉
堵住耳朵	堵住耳朵 🙉
堵着耳朵	堵着耳朵 🙉
堵耳	堵耳 🙉
堵耳朵	堵耳朵 🙉
我不听	我不听 🙉
捂上耳朵	捂上耳朵 🙉
捂住耳朵	捂住耳朵 🙉
捂着耳朵	捂着耳朵 🙉
捂耳	捂耳 🙉
捂耳朵	捂耳朵 🙉
非礼勿听	非礼勿听 🙉
非礼勿言	非礼勿言 🙊
猴子	猴子 🐒
马骝	马骝 🐒
鸡	鸡 🐔 🐓
鸡头	鸡头 🐔
企鹅	企鹅 🐧
企鹅头	企鹅头 🐧
鸟	鸟 🐦
小鸟	小鸟 🐦
鸟头	鸟头 🐦
小鸡	小鸡 🐤 🐣 🐥
小鸡头	小鸡头 🐤
小鸡宝宝	小鸡宝宝 🐤
出生	出生 🐣
孵化小鸡	孵化小鸡 🐣
小鸡破壳	小鸡破壳 🐣
破壳	破壳 🐣
小鸡鸡	小鸡鸡 🐥
站着的小鸡	站着的小鸡 🐥
大鹅	大鹅 🪿
鹅	鹅 🪿
鹅鹅鹅	鹅鹅鹅 🪿
嘎嘎	嘎嘎 🦆
鸭	鸭 🦆
小鸭子	小鸭子 🦆
鸭子	鸭子 🦆
乌鸦	乌鸦 🐦‍⬛
黑色小鸟	黑色小鸟 🐦‍⬛
黑鸟	黑鸟 🐦‍⬛
老鹰	老鹰 🦅
鹰	鹰 🦅
猫头鹰	猫头鹰 🦉
鸮	鸮 🦉
蝙蝠	蝙蝠 🦇
狼	狼 🐺
狼头	狼头 🐺
狼脸	狼脸 🐺
野猪	野猪 🐗
马	马 🐴 🐎
马头	马头 🐴
马脸	马脸 🐴
独角兽	独角兽 🦄
独角兽头	独角兽头 🦄
独角兽脸	独角兽脸 🦄
鹿	鹿 🫎 🦌
马鹿	马鹿 🫎
驼鹿	驼鹿 🫎
驼鹿头	驼鹿头 🫎
驼鹿脸	驼鹿脸 🫎
鹿头	鹿头 🫎
鹿脸	鹿脸 🫎
鹿角	鹿角 🫎
蜜蜂	蜜蜂 🐝
小蜜蜂	小蜜蜂 🐝
寄生虫	寄生虫 🪱
蚯蚓	蚯蚓 🪱
蠕虫	蠕虫 🪱
bug	bug 🐛
毛毛虫	毛毛虫 🐛
毛虫	毛虫 🐛
虫子	虫子 🐛
凤尾蝶	凤尾蝶 🦋
蝴蝶	蝴蝶 🦋
蜗牛	蜗牛 🐌
七星瓢虫	七星瓢虫 🐞
瓢虫	瓢虫 🐞
蚂蚁	蚂蚁 🐜
家蝇	家蝇 🪰
苍蝇	苍蝇 🪰
蚊蝇	蚊蝇 🪰 🦟
圣甲虫	圣甲虫 🪲
昆虫	昆虫 🪲
甲虫	甲虫 🪲
小强	小强 🪳
蟑螂	蟑螂 🪳
蚊子	蚊子 🦟
蚊虻	蚊虻 🦟
蚱蜢	蚱蜢 🦗
蛐蛐	蛐蛐 🦗
蟋蟀	蟋蟀 🦗
蜘蛛	蜘蛛 🕷
蛛网	蛛网 🕸
蜘蛛网	蜘蛛网 🕸
蝎子	蝎子 🦂
乌龟	乌龟 🐢
海龟	海龟 🐢
龟	龟 🐢
Python	Python 🐍
一条蛇	一条蛇 🐍
蛇	蛇 🐍
小蛇	小蛇 🐍
蛇蛇	蛇蛇 🐍
壁虎	壁虎 🦎
蜥蜴	蜥蜴 🦎
恐龙	恐龙 🦖 🦕
暴龙	暴龙 🦖
霸王龙	霸王龙 🦖
梁龙	梁龙 🦕
腕龙	腕龙 🦕
雷龙	雷龙 🦕
章鱼	章鱼 🐙
乌贼	乌贼 🦑
墨鱼	墨鱼 🦑
鱿鱼	鱿鱼 🦑
水母	水母 🪼
海蜇	海蜇 🪼
虾	虾 🦐
大虾	大虾 🦐
对虾	对虾 🦐
龙虾	龙虾 🦞
小龙虾	小龙虾 🦞
麻辣小龙虾	麻辣小龙虾 🦞
蟹	蟹 🦀
螃蟹	螃蟹 🦀
蟹老板	蟹老板 🦀
河豚	河豚 🐡
热带鱼	热带鱼 🐠
鱼	鱼 🐟
小鱼	小鱼 🐟
海豚	海豚 🐬
喷水	喷水 🐳
喷水的鲸	喷水的鲸 🐳
喷水的鲸鱼	喷水的鲸鱼 🐳
鲸鱼	鲸鱼 🐳 🐋
大白鲨	大白鲨 🦈
白鲨	白鲨 🦈
鲨鱼	鲨鱼 🦈
海狮	海狮 🦭
海豹	海豹 🦭
鳄鱼	鳄鱼 🐊
豹	豹 🐆
猎豹	猎豹 🐆
豹子	豹子 🐆
斑马	斑马 🦓
大猩猩	大猩猩 🦍
猩猩	猩猩 🦍 🦧
人猿	人猿 🦧
红毛猩猩	红毛猩猩 🦧
猛犸象	猛犸象 🦣
大象	大象 🐘
河马	河马 🦛
犀牛	犀牛 🦏
骆驼	骆驼 🐪 🐫
单峰骆驼	单峰骆驼 🐪
双峰骆驼	双峰骆驼 🐫
长颈鹿	长颈鹿 🦒
麒麟鹿	麒麟鹿 🦒
袋鼠	袋鼠 🦘
大野牛	大野牛 🦬
野牛	野牛 🦬
水牛	水牛 🐃
公牛	公牛 🐂
奶牛	奶牛 🐄
驴	驴 🫏
小驴	小驴 🫏
驴子	驴子 🫏
小马	小马 🐎
骏马	骏马 🐎
公羊	公羊 🐏
羊	羊 🐑
小羊	小羊 🐑
绵羊	绵羊 🐑
羊羊	羊羊 🐑
羊驼	羊驼 🦙
草泥马	草泥马 🦙
山羊	山羊 🐐
梅花鹿	梅花鹿 🦌
驯鹿	驯鹿 🦌
麋鹿	麋鹿 🦌
小狗	小狗 🐕
旺柴	旺柴 🐕
旺财	旺财 🐕
犬	犬 🐕
狗子	狗子 🐕
狗狗	狗狗 🐕
卷毛狗	卷毛狗 🐩
贵宾犬	贵宾犬 🐩
导盲犬	导盲犬 🦮
金毛	金毛 🦮
金毛寻回犬	金毛寻回犬 🦮
金毛犬	金毛犬 🦮
工作犬	工作犬 🐕‍🦺
服务犬	服务犬 🐕‍🦺
橘猫	橘猫 🐈
小黑猫	小黑猫 🐈‍⬛
黑猫	黑猫 🐈‍⬛
羽毛	羽毛 🪶
天使的翅膀	天使的翅膀 🪽
羽翼	羽翼 🪽
翅膀	翅膀 🪽
公鸡	公鸡 🐓
母鸡	母鸡 🐓
大公鸡	大公鸡 🐓
大母鸡	大母鸡 🐓
火鸡	火鸡 🦃
渡渡鸟	渡渡鸟 🦤
孔雀	孔雀 🦚
鹦鹉	鹦鹉 🦜
丑小鸭	丑小鸭 🦢
天鹅	天鹅 🦢
白天鹅	白天鹅 🦢
火烈鸟	火烈鸟 🦩
和平的象征	和平的象征 🕊
和平象征	和平象征 🕊
和平鸽	和平鸽 🕊
鸽子	鸽子 🕊
大白兔	大白兔 🐇
小兔子	小兔子 🐇
小白兔	小白兔 🐇
小浣熊	小浣熊 🦝
干脆面	干脆面 🦝
干脆面君	干脆面君 🦝
浣熊	浣熊 🦝
臭鼬	臭鼬 🦨
鼬	鼬 🦨
獾	獾 🦡
蜜獾	蜜獾 🦡
河狸	河狸 🦫
海狸	海狸 🦫
水獭	水獭 🦦
海獭	海獭 🦦
慢吞吞	慢吞吞 🦥
树懒	树懒 🦥
树懒先生	树懒先生 🦥
白鼠	白鼠 🐁
小白鼠	小白鼠 🐁
小老鼠	小老鼠 🐁
松鼠	松鼠 🐿
花栗鼠	花栗鼠 🐿
刺猬	刺猬 🦔
动物脚印	动物脚印 🐾
掌印	掌印 🐾
爪印	爪印 🐾
一条龙	一条龙 🐉
中国龙	中国龙 🐉 🐲
巨龙	巨龙 🐉
神龙	神龙 🐉
龙	龙 🐉 🐲
龙头	龙头 🐲
龙王	龙王 🐲
凤凰	凤凰 🐦‍🔥
火鸟	火鸟 🐦‍🔥
仙人掌	仙人掌 🌵
圣诞树	圣诞树 🎄
常青树	常青树 🌲
松树	松树 🌲
大树	大树 🌳
树	树 🌳
树木	树木 🌳
落叶树	落叶树 🌳
棕榈	棕榈 🌴
棕榈树	棕榈树 🌴
原木	原木 🪵
木头	木头 🪵
木材	木材 🪵
发芽	发芽 🌱
嫩苗	嫩苗 🌱
幼苗	幼苗 🌱
中药	中药 🌿
草本植物	草本植物 🌿
草药	草药 🌿
药草	药草 🌿
香草	香草 🌿
三叶草	三叶草 ☘
四叶草	四叶草 🍀
幸运草	幸运草 🍀
门松	门松 🎍
盆栽	盆栽 🪴
盆栽植物	盆栽植物 🪴
花盆	花盆 🪴
七夕	七夕 🎋
七夕树	七夕树 🎋
七夕节	七夕节 🎋
叶子	叶子 🍃
树叶	树叶 🍃
落叶	落叶 🍂
枫叶	枫叶 🍁
枫树叶	枫树叶 🍁
有蛋的巢	有蛋的巢 🪺
有蛋的鸟巢	有蛋的鸟巢 🪺
鸟巢	鸟巢 🪺
空巢	空巢 🪹
空鸟巢	空鸟巢 🪹
蘑菇	蘑菇 🍄 🍄‍🟫
小蘑菇	小蘑菇 🍄
棕色蘑菇	棕色蘑菇 🍄‍🟫
褐蘑菇	褐蘑菇 🍄‍🟫
海螺	海螺 🐚
贝壳	贝壳 🐚
珊瑚	珊瑚 🪸
珊瑚礁	珊瑚礁 🪸
岩石	岩石 🪨
石头	石头 🪨
水稻	水稻 🌾
稻穗	稻穗 🌾
麦子	麦子 🌾
麦穗	麦穗 🌾
捧花	捧花 💐
花束	花束 💐
鲜花	鲜花 💐
花	花 🌷
郁金香	郁金香 🌷
玫瑰	玫瑰 🌹
玫瑰花	玫瑰花 🌹
红玫瑰	红玫瑰 🌹
凋谢	凋谢 🥀
枯萎	枯萎 🥀
枯萎的玫瑰	枯萎的玫瑰 🥀
枯萎的花	枯萎的花 🥀
风信子	风信子 🪻
莲花	莲花 🪷
木槿	木槿 🌺
木槿花	木槿花 🌺
芙蓉	芙蓉 🌺
芙蓉花	芙蓉花 🌺
樱花	樱花 🌸
开花	开花 🌼
开花了	开花了 🌼
波斯菊	波斯菊 🌼
花朵	花朵 🌼
菊花	菊花 🌼
雏菊	雏菊 🌼
向日葵	向日葵 🌻
向阳花	向阳花 🌻
太阳花	太阳花 🌻
追日花	追日花 🌻
逐日花	逐日花 🌻
太阳	太阳 🌞 ☀️
微笑的太阳	微笑的太阳 🌞
圆月	圆月 🌝 🌕
满月	满月 🌝 🌕
微笑的月亮	微笑的月亮 🌝
微笑的满月	微笑的满月 🌝
上弦月	上弦月 🌛 🌓
微笑的上弦月	微笑的上弦月 🌛
下弦月	下弦月 🌜 🌗
微笑的下弦月	微笑的下弦月 🌜
微笑的新月	微笑的新月 🌚
微笑的朔月	微笑的朔月 🌚
新月	新月 🌚 🌑
朔月	朔月 🌚 🌑
月球	月球 🌕
亏凸月	亏凸月 🌖
月食	月食 🌘 🌒
残月	残月 🌘 🌒
眉月	眉月 🌘 🌒
蛾眉月	蛾眉月 🌘 🌒
盈凸月	盈凸月 🌔
弯月	弯月 🌙
月亮	月亮 🌙
月牙	月牙 🌙
地球	地球 🌎 🌍 🌏 🌐
地球仪	地球仪 🌎 🌍 🌏
土星	土星 🪐
星球	星球 🪐
行星	行星 🪐
有环行星	有环行星 🪐
星星	星星 ⭐ 🌟 ✨
五角星	五角星 ⭐
闪亮的星星	闪亮的星星 🌟
闪耀的星星	闪耀的星星 🌟
金光闪闪	金光闪闪 ✨
金闪闪	金闪闪 ✨
闪亮	闪亮 ✨
闪光	闪光 ✨
闪耀	闪耀 ✨
闪电	闪电 ⚡
高压电	高压电 ⚡
哈雷	哈雷 ☄️
彗星	彗星 ☄️
哈雷彗星	哈雷彗星 ☄️
爆炸	爆炸 💥
火	火 🔥
火了	火了 🔥
火焰	火焰 🔥
点燃	点燃 🔥
燃烧	燃烧 🔥
着火	着火 🔥
着火了	着火了 🔥
龙卷风	龙卷风 🌪
彩虹	彩虹 🌈
日	日 ☀️
晴天	晴天 ☀️
少云	少云 🌤
晴偶有云	晴偶有云 🌤
白日小云	白日小云 🌤
乌云蔽日	乌云蔽日 ⛅ 🌥
多云	多云 ⛅ 🌥
阴天	阴天 ⛅ 🌥
cloud	cloud ☁️
云	云 ☁️
云彩	云彩 ☁️
云朵	云朵 ☁️
天气	天气 ☁️
晴转雨	晴转雨 🌦
雨转晴	雨转晴 🌦
雨	雨 🌧
下雨	下雨 🌧
雨云	雨云 🌧
下大雨	下大雨 ⛈️
大雨	大雨 ⛈️
雷阵雨	雷阵雨 ⛈️
打雷	打雷 🌩
雷云	雷云 🌩
下雪	下雪 🌨 ❄️
雪云	雪云 🌨
雪	雪 ❄️
雪花	雪花 ❄️
雪人	雪人 ☃️ ⛄
堆雪人	堆雪人 ☃️ ⛄
雪与雪人	雪与雪人 ☃️
雪人与雪	雪人与雪 ☃️
雪人和雪	雪人和雪 ☃️
雪和雪人	雪和雪人 ☃️
吹口气	吹口气 🌬
吹拂	吹拂 🌬
吹气	吹气 🌬
吹风	吹风 🌬
风吹拂	风吹拂 🌬
风吹拂的脸	风吹拂的脸 🌬
尾气	尾气 💨
汽车尾气	汽车尾气 💨
阵风	阵风 💨
一滴	一滴 💧
一滴水	一滴水 💧
水滴	水滴 💧 💦
水珠	水珠 💧 💦
汗滴	汗滴 💧
气泡	气泡 🫧
泡泡	泡泡 🫧
打伞	打伞 ☔ ☂️
撑伞	撑伞 ☔ ☂️
伞状	伞状 ☂️
大浪	大浪 🌊
波浪	波浪 🌊
浪	浪 🌊
浪花	浪花 🌊
雾	雾 🌫
霾	霾 🌫
雾霾	雾霾 🌫
苹果	苹果 🍏 🍎
绿苹果	绿苹果 🍏
青苹果	青苹果 🍏
红苹果	红苹果 🍎
梨	梨 🍐
梨子	梨子 🍐
橘	橘 🍊
橘子	橘子 🍊
橙	橙 🍊
橙子	橙子 🍊
柠檬	柠檬 🍋 🍋‍🟩
绿柠檬	绿柠檬 🍋‍🟩
青柠檬	青柠檬 🍋‍🟩
香蕉	香蕉 🍌
吃瓜	吃瓜 🍉
西瓜	西瓜 🍉
提子	提子 🍇
葡萄	葡萄 🍇
草莓	草莓 🍓
蓝莓	蓝莓 🫐
哈密瓜	哈密瓜 🍈
新疆瓜	新疆瓜 🍈
甜瓜	甜瓜 🍈
樱桃	樱桃 🍒
桃	桃 🍑
桃子	桃子 🍑
仙桃	仙桃 🍑
芒果	芒果 🥭
凤梨	凤梨 🍍
菠萝	菠萝 🍍
椰子	椰子 🥥
椰子果	椰子果 🥥
奇异果	奇异果 🥝
猕猴桃	猕猴桃 🥝
番茄	番茄 🍅
西红柿	西红柿 🍅
茄子	茄子 🍆
牛油果	牛油果 🥑
鳄梨	鳄梨 🥑
豆荚	豆荚 🫛
豌豆	豌豆 🫛
豌豆荚	豌豆荚 🫛
西兰花	西兰花 🥦
白菜	白菜 🥬
蔬菜	蔬菜 🥬
青瓜	青瓜 🥒
黄瓜	黄瓜 🥒
红辣椒	红辣椒 🌶
辣椒	辣椒 🌶
彩椒	彩椒 🫑
灯笼椒	灯笼椒 🫑
甜椒	甜椒 🫑
菜椒	菜椒 🫑
玉米	玉米 🌽
苞米	苞米 🌽
红萝卜	红萝卜 🥕
胡萝卜	胡萝卜 🥕
萝卜	萝卜 🥕
橄榄	橄榄 🫒
青橄榄	青橄榄 🫒
黄榄	黄榄 🫒
大蒜	大蒜 🧄
大蒜头	大蒜头 🧄
蒜	蒜 🧄
蒜头	蒜头 🧄
洋葱	洋葱 🧅
洋葱头	洋葱头 🧅
洋蒜	洋蒜 🧅
葱头	葱头 🧅
土豆	土豆 🥔
马铃薯	马铃薯 🥔
地瓜	地瓜 🍠
山芋	山芋 🍠
番薯	番薯 🍠
红薯	红薯 🍠
烤地瓜	烤地瓜 🍠
烤山芋	烤山芋 🍠
烤番薯	烤番薯 🍠
烤红薯	烤红薯 🍠
姜	姜 🫚
生姜	生姜 🫚
新月形面包	新月形面包 🥐
牛角面包	牛角面包 🥐
羊角面包	羊角面包 🥐
烘焙	烘焙 🥯
百吉圈	百吉圈 🥯
百吉饼	百吉饼 🥯
面包圈	面包圈 🥯
面包	面包 🍞
法式长棍面包	法式长棍面包 🥖
长棍面包	长棍面包 🥖
长面包	长面包 🥖
椒盐卷饼	椒盐卷饼 🥨
奶酪	奶酪 🧀
芝士	芝士 🧀
起司	起司 🧀
蛋	蛋 🥚
蛋蛋	蛋蛋 🥚
鸡蛋	鸡蛋 🥚
平底锅	平底锅 🍳
烹饪	烹饪 🍳
煎蛋	煎蛋 🍳
黄乳油	黄乳油 🧈
黄油	黄油 🧈
烙饼	烙饼 🥞
煎饼	煎饼 🥞 🌯 🫔
薄煎饼	薄煎饼 🥞
蛋饼	蛋饼 🥞
华夫饼	华夫饼 🧇
格子饼	格子饼 🧇
培根	培根 🥓
烟肉	烟肉 🥓
牛排	牛排 🥩
猪排	猪排 🥩
羊排	羊排 🥩
肉	肉 🥩 🍖
肉排	肉排 🥩
肉肉	肉肉 🥩 🍖
家禽的腿	家禽的腿 🍗
家禽腿	家禽腿 🍗
鸡腿	鸡腿 🍗
鸭腿	鸭腿 🍗
吃肉	吃肉 🍖
排骨	排骨 🍖
骨头	骨头 🦴
骨骼	骨骼 🦴
热狗	热狗 🌭
汉堡	汉堡 🍔
汉堡包	汉堡包 🍔
薯条	薯条 🍟
吃比萨	吃比萨 🍕
吃比萨饼	吃比萨饼 🍕
比萨	比萨 🍕
比萨饼	比萨饼 🍕
大饼	大饼 🫓
面饼	面饼 🫓
饼	饼 🫓
三明治	三明治 🥪 🥙
夹心饼	夹心饼 🥙
炸豆丸子	炸豆丸子 🧆
肉丸	肉丸 🧆
肉丸子	肉丸子 🧆
卷饼	卷饼 🌮 🌯 🫔
墨西哥卷饼	墨西哥卷饼 🌮 🌯
墨西哥薄饼卷	墨西哥薄饼卷 🌮
煎饼馃子	煎饼馃子 🌯
墨西哥粽	墨西哥粽 🫔
墨西哥粽子	墨西哥粽子 🫔
沙拉	沙拉 🥗
绿色沙拉	绿色沙拉 🥗
蔬菜沙拉	蔬菜沙拉 🥗
一锅食物	一锅食物 🥘 🍲 🫕
火锅	火锅 🥘 🍲 🫕
食物	食物 🥘 🍲 🫕
奶酪火锅	奶酪火锅 🫕
芝士火锅	芝士火锅 🫕
起司火锅	起司火锅 🫕
罐头	罐头 🥫
罐头食品	罐头食品 🥫
玻璃瓶	玻璃瓶 🫙
瓶子	瓶子 🫙
罐子	罐子 🫙
意大利面	意大利面 🍝
意大利面条	意大利面条 🍝
意粉	意粉 🍝
意面	意面 🍝
一碗面	一碗面 🍜
吃面	吃面 🍜
拉面	拉面 🍜
碗面	碗面 🍜
面条	面条 🍜
咖喱	咖喱 🍛
咖喱饭	咖喱饭 🍛
寿司	寿司 🍣
便当	便当 🍱
便当盒	便当盒 🍱
外卖	外卖 🍱 🥡
快餐	快餐 🍱
快餐盒	快餐盒 🍱
盒饭	盒饭 🍱
水饺	水饺 🥟
饺子	饺子 🥟
牡蛎	牡蛎 🦪
生蚝	生蚝 🦪
蚝蛎	蚝蛎 🦪
天妇罗	天妇罗 🍤
炸虾	炸虾 🍤
饭团	饭团 🍙
煮熟的饭	煮熟的饭 🍚
米饭	米饭 🍚
饭	饭 🍚
米果	米果 🍘
米饼	米饼 🍘
鱼板	鱼板 🍥
鱼饼	鱼饼 🍥
幸运饼干	幸运饼干 🥠
月饼	月饼 🥮
串串	串串 🍢
关东煮	关东煮 🍢
团子	团子 🍡
糯米团	糯米团 🍡
冰沙	冰沙 🍧
刨冰	刨冰 🍧
沙冰	沙冰 🍧
冰淇淋	冰淇淋 🍨 🍦
圆筒冰淇淋	圆筒冰淇淋 🍦
甜筒	甜筒 🍦
软冰淇淋	软冰淇淋 🍦
油酥点心	油酥点心 🥧
派	派 🥧
点心	点心 🥧
纸杯蛋糕	纸杯蛋糕 🧁
蛋糕	蛋糕 🧁 🍰 🎂
水果蛋糕	水果蛋糕 🍰
生日蛋糕	生日蛋糕 🎂
布丁	布丁 🍮
甜品	甜品 🍮
甜点	甜点 🍮
蛋奶糕	蛋奶糕 🍮
棒棒糖	棒棒糖 🍭
糖	糖 🍭 🍬
吃糖	吃糖 🍬
糖果	糖果 🍬
巧克力	巧克力 🍫
巧克力棒	巧克力棒 🍫
朱古力	朱古力 🍫
朱古力棒	朱古力棒 🍫
爆米花	爆米花 🍿
油炸面圈	油炸面圈 🍩
甜甜圈	甜甜圈 🍩
cookie	cookie 🍪
cookies	cookies 🍪
曲奇	曲奇 🍪
曲奇饼干	曲奇饼干 🍪
饼干	饼干 🍪
板栗	板栗 🌰
栗子	栗子 🌰
榛子	榛子 🌰
花生	花生 🥜
落花生	落花生 🥜
豆	豆 🫘
豆子	豆子 🫘
豆类	豆类 🫘
蜂蜜	蜂蜜 🍯
蜜罐	蜜罐 🍯
一杯奶	一杯奶 🥛
杯子	杯子 🥛
牛奶	牛奶 🥛
牛奶杯	牛奶杯 🥛
倾倒	倾倒 🫗
倾倒液体	倾倒液体 🫗
喝奶	喝奶 🍼
奶瓶	奶瓶 🍼
一壶	一壶 🫖
一壶茶	一壶茶 🫖
茶壶	茶壶 🫖
咖啡	咖啡 ☕
咖啡杯	咖啡杯 ☕
喝咖啡	喝咖啡 ☕
热饮	热饮 ☕ 🍵
喝茶	喝茶 🍵
泡茶	泡茶 🍵
茶	茶 🍵
茶杯	茶杯 🍵
茶水	茶水 🍵
果汁	果汁 🧃
果汁盒	果汁盒 🧃
吸管杯	吸管杯 🥤
外带杯子	外带杯子 🥤
带吸管杯	带吸管杯 🥤
饮料	饮料 🥤
一杯奶茶	一杯奶茶 🧋
奶茶	奶茶 🧋
波霸奶茶	波霸奶茶 🧋
珍珠奶茶	珍珠奶茶 🧋
清酒	清酒 🍶
啤酒	啤酒 🍺
酒	酒 🍺 🍷 🥃
干杯	干杯 🍻 🥂
碰杯	碰杯 🍻 🥂
红酒	红酒 🍷
葡萄酒	葡萄酒 🍷
酒杯	酒杯 🍷
一杯	一杯 🥃
一杯酒	一杯酒 🥃
威士忌	威士忌 🥃
平底杯	平底杯 🥃
烈酒	烈酒 🥃
玻璃杯	玻璃杯 🥃
鸡尾酒	鸡尾酒 🍸
冷饮	冷饮 🍹
果饮	果饮 🍹
水果饮料	水果饮料 🍹
热带水果饮料	热带水果饮料 🍹
热带饮料	热带饮料 🍹
马黛茶	马黛茶 🧉
开香槟	开香槟 🍾
香槟	香槟 🍾
冰	冰 🧊
冰块	冰块 🧊
加冰	加冰 🧊
勺子	勺子 🥄
匙子	匙子 🥄
汤勺	汤勺 🥄
汤匙	汤匙 🥄
刀叉	刀叉 🍴
餐具	餐具 🍽
放着勺的碗	放着勺的碗 🥣
汤	汤 🥣
汤碗	汤碗 🥣
碗	碗 🥣
碗勺	碗勺 🥣
外卖包装	外卖包装 🥡
外卖桶	外卖桶 🥡
外卖盒	外卖盒 🥡
筷子	筷子 🥢
佐料	佐料 🧂
佐料瓶	佐料瓶 🧂
盐	盐 🧂
调味品	调味品 🧂
调味料	调味料 🧂
调味瓶	调味瓶 🧂
食盐	食盐 🧂
英式足球	英式足球 ⚽
足球	足球 ⚽
篮球	篮球 🏀
橄榄球	橄榄球 🏈 🏉
美式橄榄球	美式橄榄球 🏈
美式足球	美式足球 🏈
棒球	棒球 ⚾
垒球	垒球 🥎
网球	网球 🎾
排球	排球 🏐
英式橄榄球	英式橄榄球 🏉
飞盘	飞盘 🥏
台球	台球 🎱
桌球	桌球 🎱
黑八	黑八 🎱
悠悠球	悠悠球 🪀
溜溜球	溜溜球 🪀
乒乓球	乒乓球 🏓
乒乓球拍	乒乓球拍 🏓
球拍	球拍 🏓 🏸
羽毛球	羽毛球 🏸
羽毛球拍	羽毛球拍 🏸
冰球	冰球 🏒
曲棍球	曲棍球 🏑
袋棍球	袋棍球 🥍
板球	板球 🏏
板球拍	板球拍 🏏
回力棒	回力棒 🪃
回力镖	回力镖 🪃
回旋镖	回旋镖 🪃
回飞棒	回飞棒 🪃
飞去来器	飞去来器 🪃
飞旋镖	飞旋镖 🪃
球网	球网 🥅
球门	球门 🥅
球门网	球门网 🥅
高尔夫	高尔夫 ⛳ 🏌️‍♀️ 🏌 🏌️‍♂️
高尔夫球洞	高尔夫球洞 ⛳
放风筝	放风筝 🪁
风筝	风筝 🪁
滑梯	滑梯 🛝
滑滑梯	滑滑梯 🛝
弓和箭	弓和箭 🏹
弓箭	弓箭 🏹
渔竿	渔竿 🎣
钓竿	钓竿 🎣
钓鱼	钓鱼 🎣
钓鱼竿	钓鱼竿 🎣
深潜	深潜 🤿
潜水	潜水 🤿
潜水面罩	潜水面罩 🤿
拳击	拳击 🥊
拳击手套	拳击手套 🥊
柔道服	柔道服 🥋
武术服	武术服 🥋
空手道服	空手道服 🥋
跆拳道服	跆拳道服 🥋
运动背心	运动背心 🎽
滑板	滑板 🛹
四轮滑冰鞋	四轮滑冰鞋 🛼
旱冰	旱冰 🛼
旱冰鞋	旱冰鞋 🛼
滑旱冰	滑旱冰 🛼
轮滑	轮滑 🛼
轮滑鞋	轮滑鞋 🛼
乘雪橇	乘雪橇 🛷
坐雪橇	坐雪橇 🛷
雪橇	雪橇 🛷
驾雪橇	驾雪橇 🛷
溜冰	溜冰 ⛸
溜冰鞋	溜冰鞋 ⛸
滑冰	滑冰 ⛸
冰上溜石	冰上溜石 🥌
冰壶	冰壶 🥌
溜石	溜石 🥌
滑雪橇	滑雪橇 🎿
滑雪装备	滑雪装备 🎿
滑雪	滑雪 ⛷️
滑雪的人	滑雪的人 ⛷️
单板滑雪	单板滑雪 🏂
滑雪板	滑雪板 🏂
跳伞	跳伞 🪂
降落伞	降落伞 🪂
举重	举重 🏋️‍♀️ 🏋 🏋️‍♂️
女生举重	女生举重 🏋️‍♀️ 🏋
男生举重	男生举重 🏋️‍♂️
举重运动员	举重运动员 🏋️‍♀️ 🏋 🏋️‍♂️
女举重运动员	女举重运动员 🏋️‍♀️ 🏋
男举重运动员	男举重运动员 🏋️‍♂️
摔跤	摔跤 🤼‍♀️ 🤼 🤼‍♂️
摔跤选手	摔跤选手 🤼‍♀️ 🤼 🤼‍♂️
格斗	格斗 🤼‍♀️ 🤼 🤼‍♂️
侧手翻	侧手翻 🤸‍♀️ 🤸 🤸‍♂️
翻筋斗	翻筋斗 🤸‍♀️ 🤸 🤸‍♂️
翻跟头	翻跟头 🤸‍♀️ 🤸 🤸‍♂️
打篮球	打篮球 ⛹️‍♀️ ⛹ ⛹️‍♂️
玩篮球	玩篮球 ⛹️‍♀️ ⛹ ⛹️‍♂️
篮球运动员	篮球运动员 ⛹️‍♀️ ⛹ ⛹️‍♂️
击剑	击剑 🤺
击剑者	击剑者 🤺
击剑选手	击剑选手 🤺
剑斗	剑斗 🤺
手球	手球 🤾‍♀️ 🤾 🤾‍♂️
打手球	打手球 🤾‍♀️ 🤾 🤾‍♂️
玩手球	玩手球 🤾‍♀️ 🤾 🤾‍♂️
打高尔夫	打高尔夫 🏌️‍♀ 🏌 🏌️‍♂
打高尔夫的人	打高尔夫的人 🏌️‍♀ 🏌 🏌️‍♂
高尔夫球手	高尔夫球手 🏌️‍♀ 🏌 🏌️‍♂
赛马	赛马 🏇
赛马骑师	赛马骑师 🏇
骑马	骑马 🏇
全莲花坐	全莲花坐 🧘‍♀ 🧘 🧘‍♂
冥想	冥想 🧘‍♀ 🧘 🧘‍♂
打坐	打坐 🧘‍♀ 🧘 🧘‍♂
瑜伽	瑜伽 🧘‍♀ 🧘 🧘‍♂
瑜伽女	瑜伽女 🧘‍♀ 🧘
瑜伽男	瑜伽男 🧘‍♂
盘腿	盘腿 🧘‍♀ 🧘 🧘‍♂
盘腿的女人	盘腿的女人 🧘‍♀ 🧘
盘腿的男人	盘腿的男人 🧘‍♂
莲花坐	莲花坐 🧘‍♀ 🧘 🧘‍♂
莲花坐的人	莲花坐的人 🧘‍♀ 🧘 🧘‍♂
冲浪	冲浪 🏄‍♀ 🏄 🏄‍♂
女生冲浪	女生冲浪 🏄‍♀ 🏄
男生冲浪	男生冲浪 🏄‍♂
冲浪者	冲浪者 🏄‍♀ 🏄 🏄‍♂
泳客	泳客 🏊‍♀ 🏊 🏊‍♂
游泳	游泳 🏊‍♀ 🏊 🏊‍♂
女生游泳	女生游泳 🏊‍♀ 🏊
男生游泳	男生游泳 🏊‍♂
游泳者	游泳者 🏊‍♀ 🏊 🏊‍♂
水球	水球 🤽‍♀ 🤽 🤽‍♂
玩水球	玩水球 🤽‍♀ 🤽 🤽‍♂
女生玩水球	女生玩水球 🤽‍♀ 🤽
男生玩水球	男生玩水球 🤽‍♂
划船	划船 🚣‍♀ 🚣 🚣‍♂
划艇	划艇 🚣‍♀ 🚣 🚣‍♂
泛舟	泛舟 🚣‍♀ 🚣 🚣‍♂
攀山	攀山 🧗‍♀ 🧗 🧗‍♂
攀岩者	攀岩者 🧗‍♀ 🧗 🧗‍♂
攀爬的人	攀爬的人 🧗‍♀ 🧗 🧗‍♂
爬山	爬山 🧗‍♀ 🧗 🧗‍♂
爬山者	爬山者 🧗‍♀ 🧗 🧗‍♂
登山	登山 🧗‍♀ 🧗 🧗‍♂
登山者	登山者 🧗‍♀ 🧗 🧗‍♂
攀爬的女人	攀爬的女人 🧗‍♀ 🧗
攀爬的男人	攀爬的男人 🧗‍♂
山地自行车	山地自行车 🚵‍♀ 🚵 🚵‍♂
山地车	山地车 🚵‍♀ 🚵 🚵‍♂
骑山地车	骑山地车 🚵‍♀ 🚵 🚵‍♂
骑单车	骑单车 🚴‍♀ 🚴 🚴‍♂
骑自行车	骑自行车 🚴‍♀ 🚴 🚴‍♂
骑车	骑车 🚴‍♀ 🚴 🚴‍♂
冠军	冠军 🏆
奖杯	奖杯 🏆
金牌	金牌 🥇
银牌	银牌 🥈
铜牌	铜牌 🥉
奖牌	奖牌 🏅
运动会奖牌	运动会奖牌 🏅
军功章	军功章 🎖
勋章	勋章 🎖
鞠躬勋章	鞠躬勋章 🎖
玫瑰花结	玫瑰花结 🏵
花结	花结 🏵
丝带	丝带 🎗
黄丝带	黄丝带 🎗
门票	门票 🎫
入场券	入场券 🎟
马戏	马戏 🎪
马戏团	马戏团 🎪
马戏团帐篷	马戏团帐篷 🎪
抛接	抛接 🤹‍♀ 🤹 🤹‍♂
抛接杂耍	抛接杂耍 🤹‍♀ 🤹 🤹‍♂
杂耍	杂耍 🤹‍♀ 🤹 🤹‍♂
表演艺术	表演艺术 🎭
面具	面具 🎭
芭蕾舞鞋	芭蕾舞鞋 🩰
足尖鞋	足尖鞋 🩰
画画	画画 🎨
美术	美术 🎨
艺术	艺术 🎨
调色板	调色板 🎨
调色盘	调色盘 🎨
action	action 🎬
场记	场记 🎬
场记板	场记板 🎬
打板	打板 🎬
拍电影	拍电影 🎬
麦克风	麦克风 🎤 🎙
头戴式耳机	头戴式耳机 🎧
耳机	耳机 🎧
乐谱	乐谱 🎼
五线谱	五线谱 🎼
琴键	琴键 🎹
钢琴	钢琴 🎹
钢琴按键	钢琴按键 🎹
钢琴键	钢琴键 🎹
音乐键盘	音乐键盘 🎹
沙锤	沙锤 🪇
打鼓	打鼓 🥁
敲鼓	敲鼓 🥁
鼓	鼓 🥁
康加鼓	康加鼓 🪘
长鼓	长鼓 🪘
管弦乐器	管弦乐器 🎷
萨克斯	萨克斯 🎷
萨克斯管	萨克斯管 🎷
萨克斯风	萨克斯风 🎷
小号	小号 🎺
手风琴	手风琴 🪗
吉他	吉他 🎸
电吉他	电吉他 🎸
班卓琴	班卓琴 🪕
小提琴	小提琴 🎻
提琴	提琴 🎻
竖笛	竖笛 🪈
笛子	笛子 🪈
长笛	长笛 🪈
色子	色子 🎲
赌博	赌博 🎲 🎰
酒桌游戏	酒桌游戏 🎲
骰子	骰子 🎲
国际象棋	国际象棋 ♟
国际象棋兵	国际象棋兵 ♟
命中	命中 🎯
正中靶心的飞镖	正中靶心的飞镖 🎯
靶心	靶心 🎯
飞镖	飞镖 🎯
保龄球	保龄球 🎳
保龄球瓶	保龄球瓶 🎳
手柄	手柄 🎮
游戏手柄	游戏手柄 🎮
电子游戏手柄	电子游戏手柄 🎮
视频游戏手柄	视频游戏手柄 🎮
老虎机	老虎机 🎰
赌场	赌场 🎰
拼图	拼图 🧩
拼图块	拼图块 🧩
拼块	拼块 🧩
小汽车	小汽车 🚗 🚘
小轿车	小轿车 🚗 🚘
汽车	汽车 🚗 🚘
私家车	私家车 🚗 🚘
车	车 🚗
轿车	轿车 🚗 🚘
出租车	出租车 🚕 🚖
的士	的士 🚕 🚖
SUV	SUV 🚙
休闲车	休闲车 🚙
旅行车	旅行车 🚙
越野车	越野车 🚙
运动型多用途车	运动型多用途车 🚙
公交车	公交车 🚌 🚍
公共汽车	公共汽车 🚌 🚍
公车	公车 🚌 🚍
大巴	大巴 🚌 🚍
客车	客车 🚌 🚍
客运车	客运车 🚌 🚍
巴士	巴士 🚌 🚍
无轨电车	无轨电车 🚎
电车	电车 🚎
方程式赛车	方程式赛车 🏎
赛车	赛车 🏎
警车	警车 🚓 🚔
急救车	急救车 🚑
救护车	救护车 🚑
救火车	救火车 🚒
消防车	消防车 🚒
五菱	五菱 🚐
五菱宏光	五菱宏光 🚐
小巴	小巴 🚐
面包车	面包车 🚐
皮卡	皮卡 🛻
皮卡车	皮卡车 🛻
物流	物流 🚚
货车	货车 🚚
送货车	送货车 🚚
卡车	卡车 🚛
大卡车	大卡车 🚛
拖车	拖车 🚛
拖拉机	拖拉机 🚜
手杖	手杖 🦯
白手杖	白手杖 🦯
残疾人	残疾人 🦽 🦼 ♿
轮椅	轮椅 🦽 🦼
拐杖	拐杖 🩼
滑板车	滑板车 🛴
单车	单车 🚲
脚踏车	脚踏车 🚲
自行车	自行车 🚲
小型摩托车	小型摩托车 🛵
小电驴	小电驴 🛵
电动车	电动车 🛵
电摩	电摩 🛵
电瓶车	电瓶车 🛵
电轻摩	电轻摩 🛵
摩托	摩托 🏍
摩托车	摩托车 🏍
三脚鸡	三脚鸡 🛺
三蹦子	三蹦子 🛺
三轮摩托车	三轮摩托车 🛺
三轮车	三轮车 🛺
嘟嘟车	嘟嘟车 🛺
自动人力车	自动人力车 🛺
车轮	车轮 🛞
车轮子	车轮子 🛞
车轱辘	车轱辘 🛞
轮子	轮子 🛞
轮胎	轮胎 🛞
轱辘	轱辘 🛞
报警灯	报警灯 🚨
警灯	警灯 🚨
警车旋转灯	警车旋转灯 🚨
警车灯	警车灯 🚨
报警	报警 🚔
空中缆车	空中缆车 🚡
缆车	缆车 🚡 🚠
高山索道	高山索道 🚠
空中轨道列车	空中轨道列车 🚟
空轨	空轨 🚟
高架铁路	高架铁路 🚟
轨道车	轨道车 🚃
有轨电车	有轨电车 🚋 🚊
山区铁路	山区铁路 🚞
单轨	单轨 🚝
单轨铁路	单轨铁路 🚝
列车	列车 🚄 🚅
动车	动车 🚄 🚅
新干线	新干线 🚄 🚅
高速列车	高速列车 🚄 🚅
高铁	高铁 🚄 🚅
子弹头高速列车	子弹头高速列车 🚅
高速子弹头列车	高速子弹头列车 🚅
轻轨	轻轨 🚈
轻轨电车	轻轨电车 🚈
蒸汽火车	蒸汽火车 🚂
火车	火车 🚆
绿皮火车	绿皮火车 🚆
地下铁路	地下铁路 🚇
地铁	地铁 🚇
火车站	火车站 🚉
站台	站台 🚉
车站	车站 🚉
旅行	旅行 ✈️
飞机	飞机 ✈️
航班起飞	航班起飞 🛫
起飞	起飞 🛫
飞机起飞	飞机起飞 🛫
着陆	着陆 🛬
航班降落	航班降落 🛬
降落	降落 🛬
飞机着陆	飞机着陆 🛬
小型飞机	小型飞机 🛩
座位	座位 💺
卫星	卫星 🛰
rocket	rocket 🚀
火箭	火箭 🚀
UFO	UFO 🛸
不明飞行物	不明飞行物 🛸
飞碟	飞碟 🛸
直升机	直升机 🚁
直升飞机	直升飞机 🚁
独木舟	独木舟 🛶
帆船	帆船 ⛵
快艇	快艇 🚤
赛艇	赛艇 🚤
摩托艇	摩托艇 🛥
客船	客船 🛳
客轮	客轮 🛳
渡船	渡船 ⛴
渡轮	渡轮 ⛴
轮渡	轮渡 ⛴
海运	海运 🚢
船	船 🚢
轮船	轮船 🚢
邮轮	邮轮 🚢
救生	救生 🛟
救生圈	救生圈 🛟
泳圈	泳圈 🛟
游泳圈	游泳圈 🛟
船锚	船锚 ⚓
锚	锚 ⚓
弯钩	弯钩 🪝
挂钩	挂钩 🪝
钩子	钩子 🪝
铁钩	铁钩 🪝
加油站	加油站 ⛽
石油	石油 ⛽
前方施工	前方施工 🚧
施工	施工 🚧 🏗
施工中	施工中 🚧
施工符号	施工符号 🚧
路障	路障 🚧
交通信号灯	交通信号灯 🚦 🚥
交通灯	交通灯 🚦 🚥
信号灯	信号灯 🚦 🚥
红绿灯	红绿灯 🚦 🚥
公交站	公交站 🚏
公交车站	公交车站 🚏
公共汽车站	公共汽车站 🚏
世界地图	世界地图 🗺
复活岛	复活岛 🗿
复活节岛	复活节岛 🗿
复活节岛石像	复活节岛石像 🗿
摩艾石像	摩艾石像 🗿
自由女神	自由女神 🗽
自由女神像	自由女神像 🗽
东京塔	东京塔 🗼
城堡	城堡 🏰 🏯
欧式城堡	欧式城堡 🏰
欧洲城堡	欧洲城堡 🏰
日式城堡	日式城堡 🏯
日本城堡	日本城堡 🏯
体育场	体育场 🏟
体育馆	体育馆 🏟
足球场	足球场 🏟
摩天轮	摩天轮 🎡
过山车	过山车 🎢
旋转木马	旋转木马 🎠
游乐园	游乐园 🎠
公园	公园 ⛲
喷泉	喷泉 ⛲
沙滩伞	沙滩伞 ⛱️ 🏖
遮阳伞	遮阳伞 ⛱️
太阳伞	太阳伞 🏖
度假	度假 🏖
无人岛	无人岛 🏝
无人荒岛	无人荒岛 🏝
荒岛	荒岛 🏝
沙漠	沙漠 🏜
荒漠	荒漠 🏜
火山	火山 🌋
火山喷发	火山喷发 🌋
火山爆发	火山爆发 🌋
山	山 ⛰️
山峰	山峰 ⛰️
山脉	山脉 ⛰️
山顶	山顶 ⛰️
雪山	雪山 🏔
高山	高山 🏔
富士山	富士山 🗻
野营	野营 🏕
露营	露营 🏕
帐篷	帐篷 ⛺
小屋	小屋 🛖
草屋	草屋 🛖
蒙古包	蒙古包 🛖
住宅楼	住宅楼 🏠
家	家 🏠
房子	房子 🏠
房屋	房屋 🏠
别墅	别墅 🏡
带花园的楼房	带花园的楼房 🏡
居民区	居民区 🏘
房屋群	房屋群 🏘
危楼	危楼 🏚
废弃的房屋	废弃的房屋 🏚
荒宅	荒宅 🏚
建筑施工	建筑施工 🏗
起重机	起重机 🏗
工厂	工厂 🏭
写字楼	写字楼 🏢
办公楼	办公楼 🏢
商场	商场 🏬
商超	商超 🏬
百货商店	百货商店 🏬
超市	超市 🏬
日本邮局	日本邮局 🏣
邮局	邮局 🏣 🏤
欧洲邮局	欧洲邮局 🏤
医院	医院 🏥
银行	银行 🏦
宾馆	宾馆 🏨
旅店	旅店 🏨
旅馆	旅馆 🏨
酒店	酒店 🏨
便利商店	便利商店 🏪
便利店	便利店 🏪
商店	商店 🏪
小商店	小商店 🏪
学校	学校 🏫
教学楼	教学楼 🏫
情人宾馆	情人宾馆 🏩
情人旅店	情人旅店 🏩
情人旅馆	情人旅馆 🏩
情人酒店	情人酒店 🏩
情侣宾馆	情侣宾馆 🏩
情侣旅店	情侣旅店 🏩
情侣旅馆	情侣旅馆 🏩
情侣酒店	情侣酒店 🏩
爱情宾馆	爱情宾馆 🏩
爱情旅店	爱情旅店 🏩
爱情旅馆	爱情旅馆 🏩
爱情酒店	爱情酒店 🏩
婚礼	婚礼 💒
教堂	教堂 💒 ⛪
博物馆	博物馆 🏛 
古典建筑	古典建筑 🏛
古建筑	古建筑 🏛
圣堂	圣堂 ⛪
清真	清真 🕌
清真寺	清真寺 🕌
犹太教会堂	犹太教会堂 🕍
犹太教堂	犹太教堂 🕍
佛寺	佛寺 🛕
印度寺庙	印度寺庙 🛕
印度庙	印度庙 🛕
庙宇	庙宇 🛕
克尔白	克尔白 🕋
日本神社	日本神社 ⛩
神社	神社 ⛩
铁轨	铁轨 🛤
公路	公路 🛣
高速	高速 🛣
高速公路	高速公路 🛣
日本剪影	日本剪影 🗾
日本地图	日本地图 🗾
中秋	中秋 🎑
中秋佳节	中秋佳节 🎑
中秋节	中秋节 🎑
观月	观月 🎑
赏月	赏月 🎑
国家公园	国家公园 🏞
日出	日出 🌅 🌄
旭日	旭日 🌅 🌄
旭日东升	旭日东升 🌅 🌄
大山日出	大山日出 🌄
山中日出	山中日出 🌄
山顶日出	山顶日出 🌄
流星	流星 🌠
许愿	许愿 🌠
烟花	烟花 🎇 🎆
焰火	焰火 🎇 🎆
礼花	礼花 🎇 🎆
夕阳	夕阳 🌇
大厦夕阳	大厦夕阳 🌇
日落	日落 🌇
落日	落日 🌇
傍晚	傍晚 🌆
暮色	暮色 🌆
暮色中的城市	暮色中的城市 🌆
黄昏	黄昏 🌆
城市	城市 🏙
城市景观	城市景观 🏙
城市风光	城市风光 🏙
都市	都市 🏙
都市景观	都市景观 🏙
都市风光	都市风光 🏙
半夜	半夜 🌃
夜晚	夜晚 🌃
星光闪闪的夜晚	星光闪闪的夜晚 🌃
晚上	晚上 🌃
深夜	深夜 🌃
星空	星空 🌌
银河	银河 🌌
银河系	银河系 🌌
夜幕下的桥	夜幕下的桥 🌉
夜间大桥	夜间大桥 🌉
夜间的大桥	夜间的大桥 🌉
大桥	大桥 🌉
桥	桥 
雾气	雾气 🌁
雾气笼罩的桥	雾气笼罩的桥 🌁
雾蒙蒙	雾蒙蒙 🌁
雾都	雾都 🌁
手表	手表 ⌚
时间	时间 ⌚
手机	手机 📱
智能手机	智能手机 📱
移动电话	移动电话 📱
手机来电	手机来电 📲
来电	来电 📲
个人电脑	个人电脑 💻
手提电脑	手提电脑 💻
电脑	电脑 💻 🖥
笔电	笔电 💻
笔记本电脑	笔记本电脑 💻
电脑键盘	电脑键盘 ⌨️
键盘	键盘 ⌨️
台式电脑	台式电脑 🖥
显示器	显示器 🖥
显示屏	显示屏 🖥
计算机	计算机 🖥
印刷机	印刷机 🖨
打印机	打印机 🖨
电脑鼠标	电脑鼠标 🖱
鼠标	鼠标 🖱
轨迹球	轨迹球 🖲
摇杆	摇杆 🕹
操控杆	操控杆 🕹
游戏摇杆	游戏摇杆 🕹
游戏操控杆	游戏操控杆 🕹
夹钳	夹钳 🗜
光盘	光盘 💽
光碟	光碟 💽
电脑光盘	电脑光盘 💽
迷你光盘	迷你光盘 💽
迷你光碟	迷你光碟 💽
软盘	软盘 💾
CD	CD 💿
DVD	DVD 📀
录像带	录像带 📼
录影带	录影带 📼
磁带	磁带 📼
卡片相机	卡片相机 📷
照相机	照相机 📷
相机	相机 📷
开闪光灯的相机	开闪光灯的相机 📸
拍照	拍照 📸
闪光灯	闪光灯 📸
闪光灯打开	闪光灯打开 📸
摄像机	摄像机 📹 🎥
摄录机	摄录机 🎥
摄影机	摄影机 🎥
电影摄影机	电影摄影机 🎥
上映	上映 📽
放映机	放映机 📽
电影放映机	电影放映机 📽
电影	电影 🎞
电影胶片	电影胶片 🎞
胶卷	胶卷 🎞
胶片	胶片 🎞
菲林	菲林 🎞
电话听筒	电话听筒 📞
电话筒	电话筒 📞
固定电话	固定电话 ☎️
固话	固话 ☎️
座机	座机 ☎️
电话	电话 ☎️
传呼机	传呼机 📟
呼机	呼机 📟
寻呼机	寻呼机 📟
传真	传真 📠
传真机	传真机 📠
发传真	发传真 📠
TV	TV 📺
电视	电视 📺
电视机	电视机 📺
收音机	收音机 📻
无线电	无线电 📻
电台	电台 📻
录音室麦克风	录音室麦克风 🎙
录音麦克风	录音麦克风 🎙
滑块	滑块 🎚
电平滑块	电平滑块 🎚
控制旋钮	控制旋钮 🎛
旋钮	旋钮 🎛
指北针	指北针 🧭
指南针	指南针 🧭
方向	方向 🧭
罗盘	罗盘 🧭
秒表	秒表 ⏱
计时器	计时器 ⏱
定时器	定时器 ⏲
闹钟	闹钟 ⏰
台钟	台钟 🕰
壁炉钟	壁炉钟 🕰
座钟	座钟 🕰
沙漏	沙漏 ⌛ ⏳
卫星天线	卫星天线 📡
天线	天线 📡
接收天线	接收天线 📡
电池	电池 🔋
电源	电源 🔋 🔌
电量	电量 🔋 🪫
蓄电池	蓄电池 🔋
低电量	低电量 🪫
电池不足	电池不足 🪫
电量不足	电量不足 🪫
电量低	电量低 🪫
插头	插头 🔌
电插头	电插头 🔌
电源插头	电源插头 🔌
灯	灯 💡
灯泡	灯泡 💡
照明	照明 💡 🔦
电灯	电灯 💡
电灯泡	电灯泡 💡
白炽灯	白炽灯 💡
手电	手电 🔦
手电筒	手电筒 🔦
电筒	电筒 🔦
烛光	烛光 🕯
烛火	烛火 🕯
蜡烛	蜡烛 🕯
油灯	油灯 🪔
灭火器	灭火器 🧯
油桶	油桶 🛢
翅膀钱	翅膀钱 💸
花钱	花钱 💸
钱飞了	钱飞了 💸
长了翅膀的钱	长了翅膀的钱 💸
长翅膀的钱	长翅膀的钱 💸
纸币	纸币 💵 💴 💶 💷
钞票	钞票 💵 💴 💶 💷
美元钞票	美元钞票 💵
日元钞票	日元钞票 💴
欧元钞票	欧元钞票 💶
英镑钞票	英镑钞票 💷
硬币	硬币 🪙
钢镚	钢镚 🪙
钱币	钱币 🪙
money	money 💰
奖金	奖金 💰
工资	工资 💰
金钱	金钱 💰 💲
钱	钱 💰
钱袋	钱袋 💰
信用卡	信用卡 💳
借记卡	借记卡 💳
贷记卡	贷记卡 💳
银行卡	银行卡 💳
ID	ID 🪪 🆔
执照	执照 🪪
证件	证件 🪪
证照	证照 🪪
身份证	身份证 🪪 🆔
驾照	驾照 🪪
宝石	宝石 💎
钻石	钻石 💎
天平	天平 ⚖️
搭梯子	搭梯子 🪜
梯子	梯子 🪜
爬梯	爬梯 🪜
爬梯子	爬梯子 🪜
科学上网	科学上网 🪜
翻墙	翻墙 🪜
魔法上网	魔法上网 🪜
工具箱	工具箱 🧰
螺丝刀	螺丝刀 🪛
扳手	扳手 🔧
螺丝扳手	螺丝扳手 🔧
铁锤	铁锤 🔨
锤子	锤子 🔨
锤子与镐	锤子与镐 ⚒️
锤子和镐	锤子和镐 ⚒️
工具	工具 🛠
锤子与扳手	锤子与扳手 🛠
锤子和扳手	锤子和扳手 🛠
锤子扳手	锤子扳手 🛠
铁镐	铁镐 ⛏️
锄头	锄头 ⛏️
鹤嘴锄	鹤嘴锄 ⛏️
手锯	手锯 🪚
锯子	锯子 🪚
螺母与螺栓	螺母与螺栓 🔩
螺母及螺栓	螺母及螺栓 🔩
螺母和螺栓	螺母和螺栓 🔩
螺母螺栓	螺母螺栓 🔩
齿轮	齿轮 ⚙️
捕鼠器	捕鼠器 🪤
板砖	板砖 🧱
砖块	砖块 🧱
砖头	砖头 🧱
铁链	铁链 ⛓️ ⛓️‍💥
铁链子	铁链子 ⛓️ ⛓️‍💥
链子	链子 ⛓️ ⛓️‍💥
链条	链条 ⛓️ ⛓️‍💥
锁链	锁链 ⛓️ ⛓️‍💥
断链	断链 ⛓️‍💥
铁链子断裂	铁链子断裂 ⛓️‍💥
铁链断裂	铁链断裂 ⛓️‍💥
链子断裂	链子断裂 ⛓️‍💥
链条断裂	链条断裂 ⛓️‍💥
锁链断裂	锁链断裂 ⛓️‍💥
吸铁石	吸铁石 🧲
磁力	磁力 🧲
磁石	磁石 🧲
磁铁	磁铁 🧲
水枪	水枪 🔫
滋水枪	滋水枪 🔫
玩具枪	玩具枪 🔫
boom	boom 💣
炸弹	炸弹 💣
炸药	炸药 🧨
爆竹	爆竹 🧨
鞭炮	鞭炮 🧨
斧头	斧头 🪓
斧子	斧子 🪓
刀	刀 🔪
小刀	小刀 🔪
水果刀	水果刀 🔪
菜刀	菜刀 🔪
匕首	匕首 🗡
短刀	短刀 🗡
短剑	短剑 🗡
fight	fight ⚔️
双剑	双剑 ⚔️
双剑交叉	双剑交叉 ⚔️
开始战斗	开始战斗 ⚔️
开战	开战 ⚔️
战斗	战斗 ⚔️
盾牌	盾牌 🛡
一支烟	一支烟 🚬
卷烟	卷烟 🚬
吸烟	吸烟 🚬
抽烟	抽烟 🚬
来一根	来一根 🚬
点烟	点烟 🚬
烟	烟 🚬
烤烟	烤烟 🚬
纸烟	纸烟 🚬
香烟	香烟 🚬
棺材	棺材 ⚰️
灵柩	灵柩 ⚰️
坟墓	坟墓 🪦
墓碑	墓碑 🪦
骨坛	骨坛 ⚱️
骨灰盒	骨灰盒 ⚱️
骨灰缸	骨灰缸 ⚱️
骨瓮	骨瓮 ⚱️
双耳瓶	双耳瓶 🏺
占卜	占卜 🔮
水晶球	水晶球 🔮
念珠	念珠 📿
恶魔之眼	恶魔之眼 🧿
恶魔的眼	恶魔的眼 🧿
恶魔眼	恶魔眼 🧿
法蒂玛	法蒂玛 🪬
法蒂玛之手	法蒂玛之手 🪬
理发店	理发店 💈
理发店招牌	理发店招牌 💈
蒸馏器	蒸馏器 ⚗️
望远镜	望远镜 🔭
显微镜	显微镜 🔬
下水道	下水道 🕳
坑	坑 🕳
洞	洞 🕳
X光	X光 🩻
X光片	X光片 🩻
X射线	X射线 🩻
拍片	拍片 🩻
胸片	胸片 🩻
胸透	胸透 🩻
创口贴	创口贴 🩹
创可贴	创可贴 🩹
听诊器	听诊器 🩺
胶囊	胶囊 💊
药丸	药丸 💊
打针	打针 💉
注射器	注射器 💉
滴血	滴血 🩸
血滴	血滴 🩸
DNA	DNA 🧬
基因	基因 🧬
脱氧核糖核酸	脱氧核糖核酸 🧬
变形虫	变形虫 🦠
微生物	微生物 🦠
病毒	病毒 🦠
细菌	细菌 🦠
培养皿	培养皿 🧫
试管	试管 🧪
温度计	温度计 🌡
扫帚	扫帚 🧹
扫把	扫把 🧹
笤帚	笤帚 🧹
吸把	吸把 🪠
马桶吸	马桶吸 🪠
马桶吸把	马桶吸把 🪠
马桶吸盘	马桶吸盘 🪠
马桶塞	马桶塞 🪠
马桶抽子	马桶抽子 🪠
马桶疏通器	马桶疏通器 🪠
竹篮	竹篮 🧺
篮子	篮子 🧺
菜篮	菜篮 🧺
菜篮子	菜篮子 🧺
卫生纸	卫生纸 🧻
卷纸	卷纸 🧻
纸巾	纸巾 🧻
马桶	马桶 🚽
水龙头	水龙头 🚰
直饮水	直饮水 🚰
饮水处	饮水处 🚰
饮用水	饮用水 🚰
喷头	喷头 🚿
淋浴	淋浴 🚿
浴缸	浴缸 🛁
泡澡	泡澡 🛀
泡澡的人	泡澡的人 🛀
洗澡	洗澡 🛀
洗澡的人	洗澡的人 🛀
肥皂	肥皂 🧼
香皂	香皂 🧼
刷牙	刷牙 🪥
牙刷	牙刷 🪥
刮胡刀	刮胡刀 🪒
剃刀	剃刀 🪒
剃须刀	剃须刀 🪒
手动刮胡刀	手动刮胡刀 🪒
叉梳	叉梳 🪮
梳子	梳子 🪮
海绵	海绵 🧽
清洗	清洗 🧽
圆桶	圆桶 🪣
水桶	水桶 🪣
乳液	乳液 🧴
乳液瓶	乳液瓶 🧴
护肤霜	护肤霜 🧴
沐浴露	沐浴露 🧴
洗发水	洗发水 🧴
洗发露	洗发露 🧴
服务铃	服务铃 🛎
钥匙	钥匙 🔑 🗝
古老的钥匙	古老的钥匙 🗝
复古钥匙	复古钥匙 🗝
旧钥匙	旧钥匙 🗝
老式钥匙	老式钥匙 🗝
老钥匙	老钥匙 🗝
房门	房门 🚪
门	门 🚪
凳子	凳子 🪑
椅子	椅子 🪑
沙发	沙发 🛋
沙发和灯	沙发和灯 🛋
床	床 🛏
床上休息	床上休息 🛌
睡觉的人	睡觉的人 🛌
躺在床上的人	躺在床上的人 🛌
泰迪	泰迪 🧸
泰迪熊	泰迪熊 🧸
俄罗斯套娃	俄罗斯套娃 🪆
套娃	套娃 🪆
一幅画	一幅画 🖼
带框的画	带框的画 🖼
带画框的图片	带画框的图片 🖼
画框	画框 🖼
镜子	镜子 🪞
魔镜	魔镜 🪞
窗户	窗户 🪟
购物袋	购物袋 🛍
手推车	手推车 🛒
购物车	购物车 🛒
包装	包装 🎁
包装盒	包装盒 🎁
礼品	礼品 🎁
礼品盒	礼品盒 🎁
礼物	礼物 🎁
礼物盒	礼物盒 🎁
庆典	庆典 🎈
气球	气球 🎈
鲤鱼旗	鲤鱼旗 🎏
蝴蝶结	蝴蝶结 🎀
魔棒	魔棒 🪄
魔法棒	魔法棒 🪄
皮纳塔	皮纳塔 🪅
五彩纸屑球	五彩纸屑球 🎊
彩色碎纸	彩色碎纸 🎊
恭喜	恭喜 🎊 🎉
碎花彩球	碎花彩球 🎊
祝贺	祝贺 🎊 🎉
糖果球	糖果球 🎊
派对礼宾花	派对礼宾花 🎉
礼宾花	礼宾花 🎉
日本人偶	日本人偶 🎎
日本人形	日本人形 🎎
日本娃娃	日本娃娃 🎎
扇子	扇子 🪭
折扇	折扇 🪭
大红灯笼	大红灯笼 🏮
大红灯笼高高挂	大红灯笼高高挂 🏮
居酒屋	居酒屋 🏮
居酒屋灯笼	居酒屋灯笼 🏮
灯笼	灯笼 🏮
红灯笼	红灯笼 🏮
风铃	风铃 🎐
迪斯科	迪斯科 🪩
镜面球	镜面球 🪩
发红包	发红包 🧧
红包	红包 🧧
信件	信件 ✉️
信封	信封 ✉️
写信	写信 ✉️
收到来信	收到来信 📩 📨
收到邮件	收到邮件 📩 📨 📥
来信	来信 📩 📨
新邮件	新邮件 📨
email	email 📧
电子邮件	电子邮件 📧
邮件	邮件 📧
情书	情书 💌
收件	收件 📥
收件箱	收件箱 📥
收信	收信 📥
收邮件	收邮件 📥
发件	发件 📤
发件箱	发件箱 📤
发信	发信 📤
发邮件	发邮件 📤
包裹	包裹 📦
快递	快递 📦
打包	打包 📦
盒子	盒子 📦
箱子	箱子 📦
纸箱	纸箱 📦
纸箱子	纸箱子 📦
吊牌	吊牌 🏷
标签	标签 🏷
布告	布告 🪧
布告牌	布告牌 🪧
标语	标语 🪧
标语牌	标语牌 🪧
信箱	信箱 📪 📫 📬 📭
邮筒	邮筒 📮
邮箱	邮箱 📮
邮政喇叭	邮政喇叭 📯
卷轴	卷轴 📜
卷边的纸	卷边的纸 📃
带卷边的纸	带卷边的纸 📃
纸	纸 📃 📄
文书	文书 📄
文件	文件 📄
书签标签	书签标签 📑
标签页	标签页 📑
页签	页签 📑
凭据	凭据 🧾
发票	发票 🧾
收据	收据 🧾
账单	账单 🧾
图表	图表 📊
条形图	条形图 📊
柱形图	柱形图 📊
柱状图	柱状图 📊
上升	上升 📈 💹
上涨	上涨 📈 💹
暴涨	暴涨 📈 💹
下跌	下跌 📉
下降	下降 📉
暴跌	暴跌 📉
线圈本	线圈本 🗒
线圈笔记本	线圈笔记本 🗒
线圈日历	线圈日历 🗓
手撕日历	手撕日历 📆
日历	日历 📅
垃圾	垃圾 🗑
垃圾桶	垃圾桶 🗑
垃圾篓	垃圾篓 🗑
废纸篓	废纸篓 🗑
卡片索引	卡片索引 📇
卡牌索引	卡牌索引 📇
卡片存档盒	卡片存档盒 🗃
卡片盒	卡片盒 🗃
投票	投票 🗳
投票箱	投票箱 🗳
选票	选票 🗳
文件柜	文件柜 🗄
写字板	写字板 📋
剪贴板	剪贴板 📋
文件夹	文件夹 📁 📂
卡片索引分隔卡	卡片索引分隔卡 🗂
卷起的报纸	卷起的报纸 🗞
报纸	报纸 🗞 📰
报纸卷	报纸卷 🗞
新闻	新闻 📰
日记本	日记本 📓 📔 📒
笔记本	笔记本 📓 📔 📒
记事本	记事本 📓 📔 📒
账簿	账簿 📒
小红书	小红书 📕
第一卷	第一卷 📕
红色书本	红色书本 📕
红色的书	红色的书 📕
教科书	教科书 📗
第二卷	第二卷 📗
绿色书本	绿色书本 📗
绿色的书	绿色的书 📗
第三卷	第三卷 📘
蓝色书本	蓝色书本 📘
蓝色的书	蓝色的书 📘
橙色的书	橙色的书 📙
橙色书本	橙色书本 📙
橘色的书	橘色的书 📙
橘色书本	橘色书本 📙
第四卷	第四卷 📙
书	书 📚 📖
书本	书本 📚 📖
书籍	书籍 📚 📖
图书	图书 📚 📖
打开的书	打开的书 📖
打开的书本	打开的书本 📖
书签	书签 🔖
别针	别针 🧷
安全别针	安全别针 🧷
扣针	扣针 🧷
link	link 🔗
链接	链接 🔗
回形针	回形针 📎 🖇
曲别针	曲别针 📎 🖇
三角尺	三角尺 📐
三角板	三角板 📐
尺子	尺子 📏
直尺	直尺 📏
打算盘	打算盘 🧮
算盘	算盘 🧮
图钉	图钉 📌
圆图钉	圆图钉 📍
大头针	大头针 📍
剪刀	剪刀 ✂️
剪子	剪子 ✂️
圆珠笔	圆珠笔 🖊
钢笔	钢笔 🖋 ✒️
画笔	画笔 🖌
蜡笔	蜡笔 🖍
便笺	便笺 📝
备忘	备忘 📝
备忘录	备忘录 📝
铅笔	铅笔 ✏️
放大镜	放大镜 🔍 🔎
带墨水笔的锁	带墨水笔的锁 🔏
锁	锁 🔏 🔐 🔒 🔓
隐秘	隐秘 🔏
密钥	密钥 🔐
已锁上但挂着钥匙的锁	已锁上但挂着钥匙的锁 🔐
解锁	解锁 🔐 🔓
上锁	上锁 🔒
合上的锁	合上的锁 🔒
锁上	锁上 🔒
锁住	锁住 🔒
锁头	锁头 🔒 🔓
门锁	门锁 🔒 🔓
开锁	开锁 🔓
打开的锁	打开的锁 🔓
粉心	粉心 🩷
粉红心	粉红心 🩷
粉色心	粉色心 🩷
粉色的心	粉色的心 🩷 💕
红心	红心 ❤️ ♥️
红色心	红色心 ❤️
红色的心	红色的心 ❤️
橘心	橘心 🧡
橘色心	橘色心 🧡
橘色的心	橘色的心 🧡
橙心	橙心 🧡
橙色心	橙色心 🧡
橙色的心	橙色的心 🧡
黄心	黄心 💛
黄色心	黄色心 💛
黄色的心	黄色的心 💛
绿心	绿心 💚
绿色心	绿色心 💚
绿色的心	绿色的心 💚
淡蓝心	淡蓝心 🩵
淡蓝色心	淡蓝色心 🩵
淡蓝色的心	淡蓝色的心 🩵
蓝心	蓝心 🩵 💙
蓝色心	蓝色心 🩵 💙
蓝色的心	蓝色的心 🩵 💙
紫心	紫心 💜
紫色心	紫色心 💜
紫色的心	紫色的心 💜
黑心	黑心 🖤
黑色心	黑色心 🖤
黑色的心	黑色的心 🖤
灰心	灰心 🩶
灰色心	灰色心 🩶
灰色的心	灰色的心 🩶
白心	白心 🤍
白色心	白色心 🤍
白色的心	白色的心 🤍
棕心	棕心 🤎
棕色心	棕色心 🤎
棕色的心	棕色的心 🤎
伤心	伤心 💔
失恋	失恋 💔
心碎	心碎 💔
心在燃烧	心在燃烧 ❤️‍🔥
心在着火	心在着火 ❤️‍🔥
心火	心火 ❤️‍🔥
火上之心	火上之心 ❤️‍🔥
燃烧的心	燃烧的心 ❤️‍🔥
爱火	爱火 ❤️‍🔥
修复受伤的心灵	修复受伤的心灵 ❤️‍🩹
受伤的心	受伤的心 ❤️‍🩹
受伤的心灵	受伤的心灵 ❤️‍🩹
心伤	心伤 ❤️‍🩹
治愈的心	治愈的心 ❤️‍🩹
心叹号	心叹号 ❣️
两颗心	两颗心 💕
心连心	心连心 💞
旋转的心	旋转的心 💞
舞动的心	舞动的心 💞
心动	心动 💓
心跳	心跳 💓
搏动的心	搏动的心 💗
膨胀的心	膨胀的心 💗
膨胀的爱心	膨胀的爱心 💗
爱心	爱心 💖 ♥️
闪亮的心	闪亮的心 💖
一箭穿心	一箭穿心 💘
丘比特	丘比特 💘
心中箭了	心中箭了 💘
爱的礼物	爱的礼物 💝
系有缎带的心	系有缎带的心 💝
送你一颗心	送你一颗心 💝
饰以丝带的心	饰以丝带的心 💝
心形	心形 💟 ♥️
心形装饰	心形装饰 💟
peace	peace ☮️
世界和平	世界和平 ☮️
和平	和平 ☮️
和平标志	和平标志 ☮️
和平符号	和平符号 ☮️
十字架	十字架 ✝️
基督	基督 ✝️
基督教	基督教 ✝️
星月	星月 ☪️
奥姆	奥姆 🕉
奥姆符号	奥姆符号 🕉
法轮	法轮 ☸️
坎达	坎达 🪯
坎达符号	坎达符号 🪯
锡克	锡克 🪯
锡克教	锡克教 🪯
大卫之星	大卫之星 ✡️
六芒星	六芒星 🔯
六角星	六角星 🔯
魔法阵	魔法阵 🔯
光明节	光明节 🕎
太极	太极 ☯️
阴阳	阴阳 ☯️
东正教	东正教 ☦️
东正教十字架	东正教十字架 ☦️
祷告	祷告 🛐
蛇夫座	蛇夫座 ⛎
白羊座	白羊座 ♈
金牛座	金牛座 ♉
双子座	双子座 ♊
巨蟹座	巨蟹座 ♋
狮子座	狮子座 ♌
处女座	处女座 ♍
室女座	室女座 ♍
天秤座	天秤座 ♎
天蝎座	天蝎座 ♏
人马座	人马座 ♐
射手座	射手座 ♐
摩羯座	摩羯座 ♑
宝瓶座	宝瓶座 ♒
水瓶座	水瓶座 ♒
双鱼座	双鱼座 ♓
身份	身份 🆔
atom	atom ⚛️
原子	原子 ⚛️
原子符号	原子符号 ⚛️
可	可 🉑
放射性	放射性 ☢️
辐射	辐射 ☢️
生化危机	生化危机 ☣️
生物危害	生物危害 ☣️
瘟疫公司	瘟疫公司 ☣️
关机	关机 📴
关闭手机	关闭手机 📴
手机关机	手机关机 📴
振动模式	振动模式 📳
震动	震动 📳
收费	收费 🈶
有	有 🈶
有料	有料 🈶
无	无 🈚️
没有	没有 🈚️
申	申 🈸
申请	申请 🈸
开门营业	开门营业 🈺
营	营 🈺
营业	营业 🈺
月	月 🈷️
八角星	八角星 ✴️
Vs.	Vs. 🆚
对决	对决 🆚
对战	对战 🆚
对抗	对抗 🆚
比	比 🆚
比赛	比赛 🆚
白色的花	白色的花 💮
白花	白花 💮
得	得 🉐
讨价还价	讨价还价 🉐
秘	秘 ㊙️
祝	祝 ㊗️
祝福	祝福 ㊗️
合	合 🈴
合格	合格 🈴
没有空位	没有空位 🈵
满	满 🈵
满了	满了 🈵
满座	满座 🈵
割	割 🈹
打折	打折 🈹
严禁	严禁 🈲 🚫
禁	禁 🈲
禁止	禁止 🈲 🚫
血型	血型 🅰️ 🅱️ 🆎 🅾️
A	A 🅰️
A型	A型 🅰️
A型血	A型血 🅰️
A血型	A血型 🅰️
B	B 🅱️
B型	B型 🅱️
B型血	B型血 🅱️
B血型	B血型 🅱️
AB	AB 🆎
AB型	AB型 🆎
AB型血	AB型血 🆎
AB血型	AB血型 🆎
O	O 🅾️
O型	O型 🅾️
O型血	O型血 🅾️
O血型	O血型 🅾️
clear	clear 🆑
清理	清理 🆑
清除	清除 🆑
SOS	SOS 🆘
救命	救命 🆘
求救	求救 🆘
求救信号	求救信号 🆘
求救讯号	求救讯号 🆘
叉	叉 ❌ ❎
叉叉	叉叉 ❌ ❎
画叉	画叉 ❌ ❎
答错	答错 ❌ ❎
答错了	答错了 ❌ ❎
错	错 ❌ ❎
错号	错号 ❌ ❎
错误	错误 ❌ ❎
圆圈	圆圈 ⭕
对	对 ⭕ ✅ ✔
正确	正确 ⭕ ✅ ✔
答对	答对 ⭕ ✅
答对了	答对了 ⭕ ✅
八边形	八边形 🛑
禁止通行	禁止通行 ⛔
禁止驶入	禁止驶入 ⛔
请勿入内	请勿入内 ⛔
请勿驶入	请勿驶入 ⛔
姓名牌	姓名牌 📛
不准	不准 🚫
不许	不许 🚫
一百	一百 💯
一百分	一百分 💯
满分	满分 💯
火大	火大 💢
生气符号	生气符号 💢
青筋	青筋 💢
休息	休息 ♨️
温泉	温泉 ♨️
禁止行人	禁止行人 🚷
禁止行人通行	禁止行人通行 🚷
勿丢垃圾	勿丢垃圾 🚯
勿扔垃圾	勿扔垃圾 🚯
禁丢垃圾	禁丢垃圾 🚯
禁止丢垃圾	禁止丢垃圾 🚯
禁止乱丢垃圾	禁止乱丢垃圾 🚯
禁止乱扔垃圾	禁止乱扔垃圾 🚯
禁止扔垃圾	禁止扔垃圾 🚯
请勿乱丢垃圾	请勿乱丢垃圾 🚯
请勿乱扔垃圾	请勿乱扔垃圾 🚯
禁止自行车	禁止自行车 🚳
禁止骑行	禁止骑行 🚳
禁止骑车	禁止骑车 🚳
请勿饮用	请勿饮用 🚱
非饮用水	非饮用水 🚱
十八禁	十八禁 🔞
成人	成人 🔞
未成年	未成年 🔞
未成年不宜	未成年不宜 🔞
禁止使用手机	禁止使用手机 📵
禁止打电话	禁止打电话 📵
禁止吸烟	禁止吸烟 🚭
禁烟	禁烟 🚭
请勿吸烟	请勿吸烟 🚭
叹号	叹号 ❗ ❕
惊叹号	惊叹号 ❗ ❕
感叹号	感叹号 ❗ ❕
红叹号	红叹号 ❗
红惊叹号	红惊叹号 ❗
红感叹号	红感叹号 ❗
红色叹号	红色叹号 ❗
红色惊叹号	红色惊叹号 ❗
红色感叹号	红色感叹号 ❗
白叹号	白叹号 ❕
白惊叹号	白惊叹号 ❕
白感叹号	白感叹号 ❕
白色叹号	白色叹号 ❕
白色惊叹号	白色惊叹号 ❕
白色感叹号	白色感叹号 ❕
问号	问号 ❓ ❔
红色问号	红色问号 ❓
红问号	红问号 ❓
白色问号	白色问号 ❔
白问号	白问号 ❔
俩叹号	俩叹号 ‼️
双叹号	双叹号 ‼️
双惊叹号	双惊叹号 ‼️
双感叹号	双感叹号 ‼️
叹号问号	叹号问号 ⁉️
叹问号	叹问号 ⁉️
惊问	惊问 ⁉️
感叹号问号	感叹号问号 ⁉️
疑问惊叹	疑问惊叹 ⁉️
疑问惊叹号	疑问惊叹号 ⁉️
亮度	亮度 🔅 🔆
亮度低	亮度低 🔅
低亮度	低亮度 🔅
亮度高	亮度高 🔆
高亮度	高亮度 🔆
歌记号	歌记号 〽️
危险	危险 ⚠️
注意	注意 ⚠️
警告	警告 ⚠️
预警	预警 ⚠️
儿童过街	儿童过街 🚸
学童过街	学童过街 🚸
当心儿童	当心儿童 🚸
注意儿童	注意儿童 🚸
三叉戟	三叉戟 🔱
三叉戟标志	三叉戟标志 🔱
百合花	百合花 ⚜️
百合花饰	百合花饰 ⚜️
鸢尾花	鸢尾花 ⚜️
初学者	初学者 🔰
新手驾驶	新手驾驶 🔰
日本初学者标志	日本初学者标志 🔰
日本新手驾驶标志	日本新手驾驶标志 🔰
回收	回收 ♻️
循环	循环 ♻️
循环再生	循环再生 ♻️
循环利用	循环利用 ♻️
环保	环保 ♻️
对号	对号 ✅ ✔
对钩	对钩 ✅ ✔
指	指 🈯
火花	火花 ❇️
八轮辐星号	八轮辐星号 ✳️
子午线	子午线 🌐
经纬线	经纬线 🌐
圆点菱形	圆点菱形 💠
圆点钻石形状	圆点钻石形状 💠
圆圈M	圆圈M Ⓜ
蓝色圆圈M	蓝色圆圈M Ⓜ
台风	台风 🌀
旋风	旋风 🌀
气旋	气旋 🌀
漩涡	漩涡 🌀
蚊香	蚊香 🌀
飓风	飓风 🌀
ZZZ	ZZZ 💤
睡眠符号	睡眠符号 💤
ATM	ATM 🏧
取款机	取款机 🏧
提款机	提款机 🏧
WC	WC 🚾
卫生间	卫生间 🚾 🚻
厕所	厕所 🚾 🚻
轮椅标志	轮椅标志 ♿
parking	parking 🅿️
停车	停车 🅿️
停车场	停车场 🅿️
停车按钮	停车按钮 🅿️
泊车	泊车 🅿️
升降机	升降机 🛗
电梯	电梯 🛗
空	空 🈳
空位	空位 🈳
服务费	服务费 🈂️
安检	安检 🛂
护照检查	护照检查 🛂
护照检查处	护照检查处 🛂
检查护照	检查护照 🛂
海关	海关 🛃
海关检查	海关检查 🛃
领取行李	领取行李 🛄
行李领取	行李领取 🛄
行李领取处	行李领取处 🛄
寄存行李	寄存行李 🛅
行李寄存	行李寄存 🛅
行李寄存处	行李寄存处 🛅
Wi-Fi	Wi-Fi 🛜
WiFi	WiFi 🛜
wireless	wireless 🛜
无线局域网	无线局域网 🛜
无线网	无线网 🛜
无线网络	无线网络 🛜
网络	网络 🛜
男厕	男厕 🚹
男厕所	男厕所 🚹
男士	男士 🚹
男士标志	男士标志 🚹
男士符号	男士符号 🚹
男洗手间	男洗手间 🚹
女厕	女厕 🚺
女厕所	女厕所 🚺
女士	女士 🚺
女士标志	女士标志 🚺
女士符号	女士符号 🚺
女洗手间	女洗手间 🚺
婴儿标志	婴儿标志 🚼
婴儿符号	婴儿符号 🚼
一家人	一家人 🧑‍🧑‍🧒 🧑‍🧑‍🧒‍🧒 🧑‍🧒 🧑‍🧒‍🧒
一家三口	一家三口 🧑‍🧑‍🧒
三口之家	三口之家 🧑‍🧑‍🧒
一家四口	一家四口 🧑‍🧑‍🧒‍🧒
四口之家	四口之家 🧑‍🧑‍🧒‍🧒
单亲家庭	单亲家庭 🧑‍🧒 🧑‍🧒‍🧒
父女	父女 🧑‍🧒 🧑‍🧒‍🧒
母女	母女 🧑‍🧒 🧑‍🧒‍🧒
父子	父子 🧑‍🧒 🧑‍🧒‍🧒
母子	母子 🧑‍🧒 🧑‍🧒‍🧒
变性	变性 ⚧
跨性别	跨性别 ⚧ 🏳️‍⚧️
跨性别符号	跨性别符号 ⚧
洗手间	洗手间 🚻
盥洗室	盥洗室 🚻
丢垃圾	丢垃圾 🚮
倒垃圾	倒垃圾 🚮
垃圾丢弃处	垃圾丢弃处 🚮
垃圾入篓	垃圾入篓 🚮
垃圾入篓标志	垃圾入篓标志 🚮
扔垃圾	扔垃圾 🚮
电影院	电影院 🎦
信号	信号 📶
信号强度	信号强度 📶
信号强度条	信号强度条 📶
手机信号	手机信号 📶
这里	这里 🈁
字符	字符 🔣
符号	符号 🔣
info	info ℹ️
information	information ℹ️
资讯	资讯 ℹ️
abc	abc 🔤
字母	字母 🔤 🔡 🔠
拉丁文	拉丁文 🔤 🔡 🔠
英文	英文 🔤 🔡 🔠
英语	英语 🔤 🔡 🔠
abcd	abcd 🔡
小写	小写 🔡
小写字母	小写字母 🔡
英文小写	英文小写 🔡
ABCD	ABCD 🔠
大写	大写 🔠
大写字母	大写字母 🔠
英文大写	英文大写 🔠
NG	NG 🆖
重拍	重拍 🆖
up	up 🆙
升级	升级 🆙
顶	顶 🆙
cool	cool 🆒
很酷	很酷 🆒
特别酷	特别酷 🆒
超酷	超酷 🆒
酷	酷 🆒
new	new 🆕
全新	全新 🆕
新	新 🆕
新建	新建 🆕
新的	新的 🆕
free	free 🆓
免费	免费 🆓
自由	自由 🆓
零	零 0️⃣
一	一 1️⃣
二	二 2️⃣
三	三 3️⃣
四	四 4️⃣
五	五 5️⃣
六	六 6️⃣
七	七 7️⃣
八	八 8️⃣
九	九 9️⃣
十	十 🔟
一二三四	一二三四 🔢
数字	数字 🔢
井号	井号 #️⃣
井号键	井号键 #️⃣
星号	星号 *️⃣
星号键	星号键 *️⃣
弹出	弹出 ⏏️
弹出按钮	弹出按钮 ⏏️
推出	推出 ⏏️
推出按钮	推出按钮 ⏏️
开始	开始 ▶️
开始播放	开始播放 ▶️
播放	播放 ▶️
暂停	暂停 ⏸️
播放暂停	播放暂停 ⏯️
停止	停止 ⏹️
开始录像	开始录像 ⏺️
开始录音	开始录音 ⏺️
录像	录像 ⏺️
录像按钮	录像按钮 ⏺️
录音	录音 ⏺️
录音按钮	录音按钮 ⏺️
下一首	下一首 ⏭️
上一首	上一首 ⏮️
快进	快进 ⏩
快进符号	快进符号 ⏩
快退	快退 ⏪
快退符号	快退符号 ⏪
快上	快上 ⏫
快下	快下 ⏬
倒退	倒退 ◀️
倒退按钮	倒退按钮 ◀️
上三角	上三角 🔼
调高	调高 🔼
下三角	下三角 🔽
调低	调低 🔽
右	右 ➡️ →
右箭头	右箭头 ➡️ →
向右箭头	向右箭头 ➡️
左	左 ⬅️ ←
左箭头	左箭头 ⬅️ ←
向左箭头	向左箭头 ⬅️
上	上 ⬆️ ↑
上箭头	上箭头 ⬆️ ↑
向上箭头	向上箭头 ⬆️
下	下 ⬇️ ↓
下箭头	下箭头 ⬇️ ↓
向下箭头	向下箭头 ⬇️
右上	右上 ↗️ ↗
右上箭头	右上箭头 ↗️ ↗
右下	右下 ↘️ ↘
右下箭头	右下箭头 ↘️ ↘
左下	左下 ↙️ ↙
左下箭头	左下箭头 ↙️ ↙
左上	左上 ↖️ ↖
左上箭头	左上箭头 ↖️ ↖
上下	上下 ↕️ ↕
上下箭头	上下箭头 ↕️ ↕
左右	左右 ↔️ ↔︎
左右箭头	左右箭头 ↔️ ↔︎
左转弯箭头	左转弯箭头 ↪️
右转弯箭头	右转弯箭头 ↩️
右上弯箭头	右上弯箭头 ⤴️
右下弯箭头	右下弯箭头 ⤵️
交叉箭头	交叉箭头 🔀
随机	随机 🔀
随机播放	随机播放 🔀
循环播放	循环播放 🔁
单曲循环	单曲循环 🔂
刷新	刷新 🔄
重新载入	重新载入 🔄
逆时针	逆时针 🔄
逆时针垂直箭头	逆时针垂直箭头 🔄
逆时针方向	逆时针方向 🔄
顺时针	顺时针 🔃
顺时针垂直箭头	顺时针垂直箭头 🔃
顺时针方向	顺时针方向 🔃
音乐	音乐 🎵 🎶
音符	音符 🎵 🎶
加	加 ➕
加号	加号 ➕
减	减 ➖
减号	减号 ➖
除	除 ➗
除以	除以 ➗
除号	除号 ➗
乘	乘 ✖️
乘以	乘以 ✖️
乘号	乘号 ✖️
等于	等于 🟰
等号	等号 🟰
等于号	等于号 🟰
粗等号	粗等号 🟰
无穷大	无穷大 ♾
价钱	价钱 💲
粗美元符号	粗美元符号 💲
货币	货币 💲
兑换	兑换 💱
出国	出国 💱
外汇	外汇 💱
换汇	换汇 💱
汇率	汇率 💱
流通	流通 💱
货币兑换	货币兑换 💱
TM	TM ™
商标	商标 ™
商标符号	商标符号 ™
Copyright	Copyright ©
版权	版权 ©
版权符号	版权符号 ©
Registered	Registered ®
注册	注册 ®
注册商标	注册商标 ®
注册商标符号	注册商标符号 ®
注册标记	注册标记 ®
我是证人	我是证人 👁️‍🗨️
证人	证人 👁️‍🗨️
end	end 🔚
结束	结束 🔚
back	back 🔙
退回	退回 🔙
on	on 🔛
开启	开启 🔛
top	top 🔝
置顶	置顶 🔝
soon	soon 🔜
马上	马上 🔜
波浪型破折号	波浪型破折号 〰️
波浪线	波浪线 〰️
卷曲环	卷曲环 ➰
双卷曲环	双卷曲环 ➿
勾选	勾选 ✔ ☑️
复选	复选 ☑️
复选按钮	复选按钮 ☑️
复选框	复选框 ☑️
打对钩	打对钩 ☑️
打钩	打钩 ☑️
按钮	按钮 ☑️ 🔘
单选	单选 🔘
单选按钮	单选按钮 🔘
单选框	单选框 🔘
红色	红色 🔴 🟥
橙色	橙色 🟠 🟧
橘色	橘色 🟠 🟧
橘黄色	橘黄色 🟠 🟧
黄色	黄色 🟡 🟨
绿色	绿色 🟢 🟩
蓝色	蓝色 🔵 🟦
紫色	紫色 🟣 🟪
围棋	围棋 ⚫ ⚪
圆形	圆形 ⚫ ⚪
小圆点	小圆点 ⚫ ⚪
黑白棋	黑白棋 ⚫ ⚪
小黑点	小黑点 ⚫
黑子	黑子 ⚫
黑棋	黑棋 ⚫
黑点	黑点 ⚫
黑色	黑色 ⚫ ⬛
小白点	小白点 ⚪
白子	白子 ⚪
白棋	白棋 ⚪
白点	白点 ⚪
白色	白色 ⚪ ⬜
元宵	元宵 ⚪
汤圆	汤圆 ⚪
雪球	雪球 ⚪
棕色	棕色 🟤 🟫
三角	三角 🔺 🔻
三角形	三角形 🔺 🔻
正三角	正三角 🔺
红色正三角	红色正三角 🔺
倒三角	倒三角 🔻
红色倒三角	红色倒三角 🔻
小方片	小方片 🔸 🔹
小菱形	小菱形 🔸 🔹
橘色小菱形	橘色小菱形 🔸
橘黄色小菱形	橘黄色小菱形 🔸
橙色小菱形	橙色小菱形 🔸
蓝色小菱形	蓝色小菱形 🔹
菱形	菱形 🔶 🔷
大菱形	大菱形 🔶 🔷
橘色大菱形	橘色大菱形 🔶
橘色菱形	橘色菱形 🔶
橘黄色大菱形	橘黄色大菱形 🔶
橘黄色菱形	橘黄色菱形 🔶
橙色大菱形	橙色大菱形 🔶
橙色菱形	橙色菱形 🔶
蓝色大菱形	蓝色大菱形 🔷
蓝色菱形	蓝色菱形 🔷
方形按钮	方形按钮 🔳 🔲
正方形按钮	正方形按钮 🔳 🔲
白边方形按钮	白边方形按钮 🔳
白边正方形按钮	白边正方形按钮 🔳
黑边方形按钮	黑边方形按钮 🔲
黑边正方形按钮	黑边正方形按钮 🔲
小方块	小方块 ▪ ▫
小正方形	小正方形 ▪ ▫
黑色小方块	黑色小方块 ▪
白色小方块	白色小方块 ▫
大方块	大方块 ◾ ◽
大正方形	大正方形 ◾ ◽
黑色大方块	黑色大方块 ◾
白色大方块	白色大方块 ◽
中方块	中方块 ◼ ◻
中正方形	中正方形 ◼ ◻
中等方块	中等方块 ◼ ◻
中等正方形	中等正方形 ◼ ◻
黑色中方块	黑色中方块 ◼
黑色中等方块	黑色中等方块 ◼
白色中方块	白色中方块 ◻
白色中等方块	白色中等方块 ◻
方块	方块 ⬛ ⬜ ♦️
方形	方形 ⬛ ⬜
正方形	正方形 ⬛ ⬜
矩形	矩形 ⬛ ⬜
小黑框	小黑框 ⬛
黑框	黑框 ⬛
小白框	小白框 ⬜
白框	白框 ⬜
扬声器	扬声器 🔈 🔉 🔊
已静音的扬声器	已静音的扬声器 🔇
扬声器关闭	扬声器关闭 🔇
静音	静音 🔇 🔕
中等音量	中等音量 🔉
中等音量的扬声器	中等音量的扬声器 🔉
大音量	大音量 🔊
高音量	高音量 🔊
高音量的扬声器	高音量的扬声器 🔊
铃铛	铃铛 🔔
响铃关闭	响铃关闭 🔕
禁止响铃	禁止响铃 🔕
静音铃铛	静音铃铛 🔕
喇叭	喇叭 📣 📢
喇叭筒	喇叭筒 📣
大喇叭	大喇叭 📣
公共广播	公共广播 📢
对话框	对话框 💬 🗨 💭 🗯
对话气泡	对话气泡 💬 🗨 🗯
朝左的对话气泡	朝左的对话气泡 🗨
内心活动气泡	内心活动气泡 💭
思考气泡	思考气泡 💭
愤怒对话框	愤怒对话框 🗯
愤怒对话气泡	愤怒对话气泡 🗯
扑克	扑克 ♠️ ♥️ ♦️ ♣️ 🃏
黑桃	黑桃 ♠️
梅花	梅花 ♣️
草花	草花 ♣️
心	心 ♥️
爱	爱 ♥️
红桃	红桃 ♥️
方板	方板 ♦️
方片	方片 ♦️
joker	joker 🃏
大小王	大小王 🃏
大王	大王 🃏
小丑牌	小丑牌 🃏
小王	小王 🃏
鬼牌	鬼牌 🃏
扑克牌	扑克牌 🎴
花扑克牌	花扑克牌 🎴
中	中 🀄
红中	红中 🀄
麻将	麻将 🀄
一点钟	一点钟 🕐
两点	两点 🕑
两点钟	两点钟 🕑
三点	三点 🕒
三点钟	三点钟 🕒
四点	四点 🕓
四点钟	四点钟 🕓
五点	五点 🕔
五点钟	五点钟 🕔
六点	六点 🕕
六点钟	六点钟 🕕
七点	七点 🕖
七点钟	七点钟 🕖
八点	八点 🕗
八点钟	八点钟 🕗
九点	九点 🕘
九点钟	九点钟 🕘
十点	十点 🕙
十点钟	十点钟 🕙
十一点	十一点 🕚
十一点钟	十一点钟 🕚
十二点	十二点 🕛
十二点钟	十二点钟 🕛
一点半	一点半 🕜
两点半	两点半 🕝
三点半	三点半 🕞
四点半	四点半 🕟
五点半	五点半 🕠
六点半	六点半 🕡
七点半	七点半 🕢
八点半	八点半 🕣
九点半	九点半 🕤
十点半	十点半 🕥
十一点半	十一点半 🕦
十二点半	十二点半 🕧
举白旗	举白旗 🏳
投降	投降 🏳
白旗	白旗 🏳
白色旗子	白色旗子 🏳
白色旗帜	白色旗帜 🏳
认输	认输 🏳
认输了	认输了 🏳
举黑旗	举黑旗 🏴
黑旗	黑旗 🏴
黑色旗	黑色旗 🏴
黑色旗子	黑色旗子 🏴
黑色旗帜	黑色旗帜 🏴
海盗	海盗 🏴‍☠️
海盗旗	海盗旗 🏴‍☠️
海贼	海贼 🏴‍☠️
海贼旗	海贼旗 🏴‍☠️
格子旗	格子旗 🏁
终点	终点 🏁
终点旗	终点旗 🏁
三角旗	三角旗 🚩
旗子	旗子 🚩
旗帜	旗帜 🚩
旗杆上的三角旗	旗杆上的三角旗 🚩
旗杆上的旗帜	旗杆上的旗帜 🚩
红色旗帜	红色旗帜 🚩
同性旗	同性旗 🏳️‍🌈
彩虹旗	彩虹旗 🏳️‍🌈
跨性别旗	跨性别旗 🏳️‍⚧️
联合国	联合国 🇺🇳
阿尔巴尼亚	阿尔巴尼亚 🇦🇱
阿尔巴尼亚共和国	阿尔巴尼亚共和国 🇦🇱
阿尔及利亚	阿尔及利亚 🇩🇿
阿尔及利亚民主人民共和国	阿尔及利亚民主人民共和国 🇩🇿
阿富汗	阿富汗 🇦🇫
阿根廷	阿根廷 🇦🇷
阿根廷共和国	阿根廷共和国 🇦🇷
阿拉伯联合酋长国	阿拉伯联合酋长国 🇦🇪
阿拉伯	阿拉伯 🇦🇪
阿鲁巴	阿鲁巴 🇦🇼
阿曼	阿曼 🇴🇲
阿曼苏丹国	阿曼苏丹国 🇴🇲
阿塞拜疆	阿塞拜疆 🇦🇿
阿塞拜疆共和国	阿塞拜疆共和国 🇦🇿
埃及	埃及 🇪🇬
埃塞俄比亚	埃塞俄比亚 🇪🇹
埃塞俄比亚联邦民主共和国	埃塞俄比亚联邦民主共和国 🇪🇹
爱尔兰	爱尔兰 🇮🇪
爱尔兰共和国	爱尔兰共和国 🇮🇪
爱沙尼亚	爱沙尼亚 🇪🇪
爱沙尼亚共和国	爱沙尼亚共和国 🇪🇪
安道尔	安道尔 🇦🇩
安道尔公国	安道尔公国 🇦🇩
安哥拉	安哥拉 🇦🇴
安哥拉共和国	安哥拉共和国 🇦🇴
安圭拉	安圭拉 🇦🇮
安提瓜和巴布达	安提瓜和巴布达 🇦🇬
安巴	安巴 🇦🇬
奥地利	奥地利 🇦🇹
奥地利共和国	奥地利共和国 🇦🇹
奥兰	奥兰 🇦🇽
奥兰群岛	奥兰群岛 🇦🇽
阿赫韦南马	阿赫韦南马 🇦🇽
澳大利亚	澳大利亚 🇦🇺
澳大利亚联邦	澳大利亚联邦 🇦🇺
中国澳门特别行政区	中国澳门特别行政区 🇲🇴
中国澳门	中国澳门 🇲🇴
澳门	澳门 🇲🇴
澳门特别行政区	澳门特别行政区 🇲🇴
巴巴多斯	巴巴多斯 🇧🇧
巴布亚新几内亚	巴布亚新几内亚 🇵🇬
巴布亚新几内亚独立国	巴布亚新几内亚独立国 🇵🇬
巴哈马	巴哈马 🇧🇸
巴哈马国	巴哈马国 🇧🇸
巴基斯坦	巴基斯坦 🇵🇰
巴基斯坦伊斯兰共和国	巴基斯坦伊斯兰共和国 🇵🇰
巴拉圭	巴拉圭 🇵🇾
巴拉圭共和国	巴拉圭共和国 🇵🇾
巴勒斯坦领土	巴勒斯坦领土 🇵🇸
巴林	巴林 🇧🇭
巴林王国	巴林王国 🇧🇭
巴拿马	巴拿马 🇵🇦
巴拿马共和国	巴拿马共和国 🇵🇦
巴西	巴西 🇧🇷
巴西联邦	巴西联邦 🇧🇷
巴西联邦共和国	巴西联邦共和国 🇧🇷
白俄罗斯	白俄罗斯 🇧🇾
白俄	白俄 🇧🇾
百慕大	百慕大 🇧🇲
保加利亚	保加利亚 🇧🇬
保加利亚共和国	保加利亚共和国 🇧🇬
北马里亚纳群岛	北马里亚纳群岛 🇲🇵
北马其顿	北马其顿 🇲🇰
北马其顿共和国	北马其顿共和国 🇲🇰
贝宁	贝宁 🇧🇯
贝宁共和国	贝宁共和国 🇧🇯
比利时	比利时 🇧🇪
比利时王国	比利时王国 🇧🇪
秘鲁	秘鲁 🇵🇪
秘鲁共和国	秘鲁共和国 🇵🇪
冰岛	冰岛 🇮🇸
波多黎各	波多黎各 🇵🇷
波兰	波兰 🇵🇱
波兰共和国	波兰共和国 🇵🇱
波斯尼亚和黑塞哥维那	波斯尼亚和黑塞哥维那 🇧🇦
波黑	波黑 🇧🇦
玻利维亚	玻利维亚 🇧🇴
玻利维亚国	玻利维亚国 🇧🇴
多民族玻利维亚国	多民族玻利维亚国 🇧🇴
伯利兹	伯利兹 🇧🇿
博茨瓦纳	博茨瓦纳 🇧🇼
博茨瓦纳共和国	博茨瓦纳共和国 🇧🇼
不丹	不丹 🇧🇹
不丹王国	不丹王国 🇧🇹
布基纳法索	布基纳法索 🇧🇫
布隆迪	布隆迪 🇧🇮
布隆迪共和国	布隆迪共和国 🇧🇮
英属印度洋领地	英属印度洋领地 🇮🇴
朝鲜	朝鲜 🇰🇵
北朝鲜	北朝鲜 🇰🇵
北韩	北韩 🇰🇵
赤道几内亚	赤道几内亚 🇬🇶
丹麦	丹麦 🇩🇰
德国	德国 🇩🇪
德意志	德意志 🇩🇪
德意志联邦共和国	德意志联邦共和国 🇩🇪
德意志联邦	德意志联邦 🇩🇪
东帝汶	东帝汶 🇹🇱
东帝汶民主共和国	东帝汶民主共和国 🇹🇱
多哥	多哥 🇹🇬
多哥共和国	多哥共和国 🇹🇬
多米尼加共和国	多米尼加共和国 🇩🇴
多米尼克	多米尼克 🇩🇲
多米尼克国	多米尼克国 🇩🇲
俄罗斯	俄罗斯 🇷🇺
俄国	俄国 🇷🇺
俄罗斯联邦	俄罗斯联邦 🇷🇺
厄瓜多尔	厄瓜多尔 🇪🇨
厄瓜多尔共和国	厄瓜多尔共和国 🇪🇨
厄立特里亚	厄立特里亚 🇪🇷
厄立特里亚国	厄立特里亚国 🇪🇷
法国	法国 🇫🇷
法兰西	法兰西 🇫🇷
法兰西共和国	法兰西共和国 🇫🇷
法罗群岛	法罗群岛 🇫🇴
法属波利尼西亚	法属波利尼西亚 🇵🇫
法属圭亚那	法属圭亚那 🇬🇫
法属南部领地	法属南部领地 🇹🇫
梵蒂冈	梵蒂冈 🇻🇦
梵蒂冈城国	梵蒂冈城国 🇻🇦
菲律宾	菲律宾 🇵🇭
菲律宾共和国	菲律宾共和国 🇵🇭
斐济	斐济 🇫🇯
斐济共和国	斐济共和国 🇫🇯
芬兰	芬兰 🇫🇮
芬兰共和国	芬兰共和国 🇫🇮
佛得角	佛得角 🇨🇻
佛得角共和国	佛得角共和国 🇨🇻
福克兰群岛	福克兰群岛 🇫🇰
马尔维纳斯群岛	马尔维纳斯群岛 🇫🇰
冈比亚	冈比亚 🇬🇲
冈比亚共和国	冈比亚共和国 🇬🇲
刚果（布）	刚果（布） 🇨🇬
刚果布	刚果布 🇨🇬
刚果	刚果 🇨🇬 🇨🇩
刚果（金）	刚果（金） 🇨🇩
刚果金	刚果金 🇨🇩
哥伦比亚	哥伦比亚 🇨🇴
哥伦比亚共和国	哥伦比亚共和国 🇨🇴
哥斯达黎加	哥斯达黎加 🇨🇷
哥斯达黎加共和国	哥斯达黎加共和国 🇨🇷
格林纳达	格林纳达 🇬🇩
格陵兰	格陵兰 🇬🇱
格鲁吉亚	格鲁吉亚 🇬🇪
根西岛	根西岛 🇬🇬
古巴	古巴 🇨🇺
古巴共和国	古巴共和国 🇨🇺
瓜德罗普	瓜德罗普 🇬🇵
关岛	关岛 🇬🇺
圭亚那	圭亚那 🇬🇾
圭亚那合作共和国	圭亚那合作共和国 🇬🇾
哈萨克斯坦	哈萨克斯坦 🇰🇿
哈萨克斯坦共和国	哈萨克斯坦共和国 🇰🇿
海地	海地 🇭🇹
海地共和国	海地共和国 🇭🇹
韩国	韩国 🇰🇷
南朝鲜	南朝鲜 🇰🇷
南韩	南韩 🇰🇷
荷兰	荷兰 🇳🇱
尼德兰	尼德兰 🇳🇱
荷属加勒比区	荷属加勒比区 🇧🇶
荷属圣马丁	荷属圣马丁 🇸🇽
圣马丁	圣马丁 🇸🇽
黑山	黑山 🇲🇪
洪都拉斯	洪都拉斯 🇭🇳
洪都拉斯共和国	洪都拉斯共和国 🇭🇳
基里巴斯	基里巴斯 🇰🇮
基里巴斯共和国	基里巴斯共和国 🇰🇮
吉布提	吉布提 🇩🇯
吉布提共和国	吉布提共和国 🇩🇯
吉尔吉斯斯坦	吉尔吉斯斯坦 🇰🇬
吉尔吉斯共和国	吉尔吉斯共和国 🇰🇬
几内亚	几内亚 🇬🇳
几内亚共和国	几内亚共和国 🇬🇳
几内亚比绍	几内亚比绍 🇬🇼
几内亚比绍共和国	几内亚比绍共和国 🇬🇼
加拿大	加拿大 🇨🇦
加纳	加纳 🇬🇭
加纳共和国	加纳共和国 🇬🇭
加纳利群岛	加纳利群岛 🇮🇨
加蓬	加蓬 🇬🇦
柬埔寨	柬埔寨 🇰🇭
柬埔寨王国	柬埔寨王国 🇰🇭
捷克	捷克 🇨🇿
捷克共和国	捷克共和国 🇨🇿
津巴布韦	津巴布韦 🇿🇼
津巴布韦共和国	津巴布韦共和国 🇿🇼
喀麦隆	喀麦隆 🇨🇲
喀麦隆共和国	喀麦隆共和国 🇨🇲
卡塔尔	卡塔尔 🇶🇦
卡塔尔国	卡塔尔国 🇶🇦
开曼群岛	开曼群岛 🇰🇾
科科斯（基林）群岛	科科斯（基林）群岛 🇨🇨
科科斯	科科斯 🇨🇨
科摩罗	科摩罗 🇰🇲
科摩罗联盟	科摩罗联盟 🇰🇲
科索沃	科索沃 🇽🇰
科索沃共和国	科索沃共和国 🇽🇰
科特迪瓦	科特迪瓦 🇨🇮
科特迪瓦共和国	科特迪瓦共和国 🇨🇮
科威特	科威特 🇰🇼
科威特国	科威特国 🇰🇼
克罗地亚	克罗地亚 🇭🇷
克罗地亚共和国	克罗地亚共和国 🇭🇷
肯尼亚	肯尼亚 🇰🇪
肯尼亚共和国	肯尼亚共和国 🇰🇪
库克群岛	库克群岛 🇨🇰
库拉索	库拉索 🇨🇼
拉脱维亚	拉脱维亚 🇱🇻
拉脱维亚共和国	拉脱维亚共和国 🇱🇻
莱索托	莱索托 🇱🇸
莱索托王国	莱索托王国 🇱🇸
老挝	老挝 🇱🇦
老挝人民民主共和国	老挝人民民主共和国 🇱🇦
黎巴嫩	黎巴嫩 🇱🇧
黎巴嫩共和国	黎巴嫩共和国 🇱🇧
立陶宛	立陶宛 🇱🇹
立陶宛共和国	立陶宛共和国 🇱🇹
利比里亚	利比里亚 🇱🇷
利比里亚共和国	利比里亚共和国 🇱🇷
利比亚	利比亚 🇱🇾
利比亚国	利比亚国 🇱🇾
列支敦士登	列支敦士登 🇱🇮
列支敦士登公国	列支敦士登公国 🇱🇮
留尼汪	留尼汪 🇷🇪
卢森堡	卢森堡 🇱🇺
卢森堡大公国	卢森堡大公国 🇱🇺
卢旺达	卢旺达 🇷🇼
卢旺达共和国	卢旺达共和国 🇷🇼
罗马尼亚	罗马尼亚 🇷🇴
马达加斯加	马达加斯加 🇲🇬
马达加斯加共和国	马达加斯加共和国 🇲🇬
马恩岛	马恩岛 🇮🇲
马尔代夫	马尔代夫 🇲🇻
马尔代夫共和国	马尔代夫共和国 🇲🇻
马耳他	马耳他 🇲🇹
马耳他共和国	马耳他共和国 🇲🇹
马拉维	马拉维 🇲🇼
马拉维共和国	马拉维共和国 🇲🇼
马来西亚	马来西亚 🇲🇾
马里	马里 🇲🇱
马里共和国	马里共和国 🇲🇱
马绍尔群岛	马绍尔群岛 🇲🇭
马提尼克	马提尼克 🇲🇶
马约特	马约特 🇾🇹
毛里求斯	毛里求斯 🇲🇺
毛里求斯共和国	毛里求斯共和国 🇲🇺
毛里塔尼亚	毛里塔尼亚 🇲🇷
毛里塔尼亚伊斯兰共和国	毛里塔尼亚伊斯兰共和国 🇲🇷
美国	美国 🇺🇸
美利坚	美利坚 🇺🇸
美利坚合众国	美利坚合众国 🇺🇸
星条旗	星条旗 🇺🇸
美属萨摩亚	美属萨摩亚 🇦🇸
东萨摩亚	东萨摩亚 🇦🇸
美属维尔京群岛	美属维尔京群岛 🇻🇮
蒙古	蒙古 🇲🇳
蒙古国	蒙古国 🇲🇳
蒙特塞拉特	蒙特塞拉特 🇲🇸
孟加拉国	孟加拉国 🇧🇩
孟加拉	孟加拉 🇧🇩
密克罗尼西亚	密克罗尼西亚 🇫🇲
缅甸	缅甸 🇲🇲
缅甸联邦	缅甸联邦 🇲🇲
缅甸联邦共和国	缅甸联邦共和国 🇲🇲
摩尔多瓦	摩尔多瓦 🇲🇩
摩尔多瓦共和国	摩尔多瓦共和国 🇲🇩
摩洛哥	摩洛哥 🇲🇦
摩洛哥王国	摩洛哥王国 🇲🇦
摩纳哥	摩纳哥 🇲🇨
摩纳哥公国	摩纳哥公国 🇲🇨
莫桑比克	莫桑比克 🇲🇿
莫桑比克共和国	莫桑比克共和国 🇲🇿
墨西哥	墨西哥 🇲🇽
墨西哥合众国	墨西哥合众国 🇲🇽
纳米比亚	纳米比亚 🇳🇦
纳米比亚共和国	纳米比亚共和国 🇳🇦
南非	南非 🇿🇦
南非共和国	南非共和国 🇿🇦
南极洲	南极洲 🇦🇶
南乔治亚和南桑威奇群岛	南乔治亚和南桑威奇群岛 🇬🇸
南苏丹	南苏丹 🇸🇸
南苏丹共和国	南苏丹共和国 🇸🇸
瑙鲁	瑙鲁 🇳🇷
瑙鲁共和国	瑙鲁共和国 🇳🇷
尼加拉瓜	尼加拉瓜 🇳🇮
尼加拉瓜共和国	尼加拉瓜共和国 🇳🇮
尼泊尔	尼泊尔 🇳🇵
尼日尔	尼日尔 🇳🇪
尼日尔共和国	尼日尔共和国 🇳🇪
尼日利亚	尼日利亚 🇳🇬
尼日利亚联邦	尼日利亚联邦 🇳🇬
尼日利亚联邦共和国	尼日利亚联邦共和国 🇳🇬
纽埃	纽埃 🇳🇺
挪威	挪威 🇳🇴
挪威王国	挪威王国 🇳🇴
诺福克岛	诺福克岛 🇳🇫
欧盟	欧盟 🇪🇺
欧洲联盟	欧洲联盟 🇪🇺
帕劳	帕劳 🇵🇼
帕劳共和国	帕劳共和国 🇵🇼
皮特凯恩群岛	皮特凯恩群岛 🇵🇳
葡萄牙	葡萄牙 🇵🇹
葡萄牙共和国	葡萄牙共和国 🇵🇹
日本	日本 🇯🇵
日本国	日本国 🇯🇵
交叉旗	交叉旗 🎌
瑞典	瑞典 🇸🇪
瑞典王国	瑞典王国 🇸🇪
瑞士	瑞士 🇨🇭
瑞士联邦	瑞士联邦 🇨🇭
萨尔瓦多	萨尔瓦多 🇸🇻
萨尔瓦多共和国	萨尔瓦多共和国 🇸🇻
萨摩亚	萨摩亚 🇼🇸
萨摩亚独立国	萨摩亚独立国 🇼🇸
塞尔维亚	塞尔维亚 🇷🇸
塞尔维亚共和国	塞尔维亚共和国 🇷🇸
塞拉利昂	塞拉利昂 🇸🇱
塞拉利昂共和国	塞拉利昂共和国 🇸🇱
塞内加尔	塞内加尔 🇸🇳
塞内加尔共和国	塞内加尔共和国 🇸🇳
塞浦路斯	塞浦路斯 🇨🇾
塞浦路斯共和国	塞浦路斯共和国 🇨🇾
塞舌尔	塞舌尔 🇸🇨
塞舌尔共和国	塞舌尔共和国 🇸🇨
沙特	沙特 🇸🇦
沙特阿拉伯	沙特阿拉伯 🇸🇦
沙特阿拉伯王国	沙特阿拉伯王国 🇸🇦
圣巴泰勒米	圣巴泰勒米 🇧🇱
圣诞岛	圣诞岛 🇨🇽
圣多美和普林西比	圣多美和普林西比 🇸🇹
圣多美和普林西比民主共和国	圣多美和普林西比民主共和国 🇸🇹
圣赫勒拿	圣赫勒拿 🇸🇭
圣基茨和尼维斯	圣基茨和尼维斯 🇰🇳
圣卢西亚	圣卢西亚 🇱🇨
圣马力诺	圣马力诺 🇸🇲
圣马力诺共和国	圣马力诺共和国 🇸🇲
圣皮埃尔和密克隆群岛	圣皮埃尔和密克隆群岛 🇵🇲
圣文森特和格林纳丁斯	圣文森特和格林纳丁斯 🇻🇨
斯里兰卡	斯里兰卡 🇱🇰
斯里兰卡民主社会主义共和国	斯里兰卡民主社会主义共和国 🇱🇰
斯洛伐克	斯洛伐克 🇸🇰
斯洛伐克共和国	斯洛伐克共和国 🇸🇰
斯洛文尼亚	斯洛文尼亚 🇸🇮
斯洛文尼亚共和国	斯洛文尼亚共和国 🇸🇮
斯威士兰	斯威士兰 🇸🇿
斯威士兰王国	斯威士兰王国 🇸🇿
苏丹	苏丹 🇸🇩
苏丹共和国	苏丹共和国 🇸🇩
苏里南	苏里南 🇸🇷
苏里南共和国	苏里南共和国 🇸🇷
所罗门群岛	所罗门群岛 🇸🇧
索马里	索马里 🇸🇴
索马里联邦	索马里联邦 🇸🇴
索马里联邦共和国	索马里联邦共和国 🇸🇴
塔吉克斯坦	塔吉克斯坦 🇹🇯
塔吉克斯坦共和国	塔吉克斯坦共和国 🇹🇯
泰国	泰国 🇹🇭
泰王国	泰王国 🇹🇭
暹罗	暹罗 🇹🇭
坦桑尼亚	坦桑尼亚 🇹🇿
坦桑尼亚联合共和国	坦桑尼亚联合共和国 🇹🇿
汤加	汤加 🇹🇴
汤加王国	汤加王国 🇹🇴
特克斯和凯科斯群岛	特克斯和凯科斯群岛 🇹🇨
特立尼达和多巴哥	特立尼达和多巴哥 🇹🇹
特立尼达和多巴哥共和国	特立尼达和多巴哥共和国 🇹🇹
突尼斯	突尼斯 🇹🇳
突尼斯共和国	突尼斯共和国 🇹🇳
图瓦卢	图瓦卢 🇹🇻
土耳其	土耳其 🇹🇷
土耳其共和国	土耳其共和国 🇹🇷
土库曼斯坦	土库曼斯坦 🇹🇲
托克劳	托克劳 🇹🇰
瓦利斯和富图纳	瓦利斯和富图纳 🇼🇫
瓦努阿图	瓦努阿图 🇻🇺
瓦努阿图共和国	瓦努阿图共和国 🇻🇺
危地马拉	危地马拉 🇬🇹
委内瑞拉	委内瑞拉 🇻🇪
委内瑞拉玻利瓦尔共和国	委内瑞拉玻利瓦尔共和国 🇻🇪
文莱	文莱 🇧🇳
文莱达鲁萨兰国	文莱达鲁萨兰国 🇧🇳
乌干达	乌干达 🇺🇬
乌干达共和国	乌干达共和国 🇺🇬
乌克兰	乌克兰 🇺🇦
乌拉圭	乌拉圭 🇺🇾
乌拉圭东岸共和国	乌拉圭东岸共和国 🇺🇾
乌兹别克斯坦	乌兹别克斯坦 🇺🇿
乌兹别克斯坦共和国	乌兹别克斯坦共和国 🇺🇿
西班牙	西班牙 🇪🇸
西班牙王国	西班牙王国 🇪🇸
西撒哈拉	西撒哈拉 🇪🇭
希腊	希腊 🇬🇷
希腊共和国	希腊共和国 🇬🇷
中国香港特别行政区	中国香港特别行政区 🇭🇰
中国香港	中国香港 🇭🇰
香港	香港 🇭🇰
香港特别行政区	香港特别行政区 🇭🇰
新加坡	新加坡 🇸🇬
新加坡共和国	新加坡共和国 🇸🇬
新喀里多尼亚	新喀里多尼亚 🇳🇨
新西兰	新西兰 🇳🇿
匈牙利	匈牙利 🇭🇺
叙利亚	叙利亚 🇸🇾
叙利亚共和国	叙利亚共和国 🇸🇾
阿拉伯叙利亚共和国	阿拉伯叙利亚共和国 🇸🇾
牙买加	牙买加 🇯🇲
亚美尼亚	亚美尼亚 🇦🇲
亚美尼亚共和国	亚美尼亚共和国 🇦🇲
也门	也门 🇾🇪
也门共和国	也门共和国 🇾🇪
伊拉克	伊拉克 🇮🇶
伊拉克共和国	伊拉克共和国 🇮🇶
伊朗	伊朗 🇮🇷
伊朗伊斯兰共和国	伊朗伊斯兰共和国 🇮🇷
以色列	以色列 🇮🇱
以色列国	以色列国 🇮🇱
意大利	意大利 🇮🇹
意大利共和国	意大利共和国 🇮🇹
印度	印度 🇮🇳
印度共和国	印度共和国 🇮🇳
印度尼西亚	印度尼西亚 🇮🇩
印度尼西亚共和国	印度尼西亚共和国 🇮🇩
英国	英国 🇬🇧
英伦	英伦 🇬🇧
大不列颠及北爱尔兰联合王国	大不列颠及北爱尔兰联合王国 🇬🇧
英格兰	英格兰 🏴󠁧󠁢󠁥󠁮󠁧󠁿
苏格兰	苏格兰 🏴󠁧󠁢󠁳󠁣󠁴󠁿
威尔士	威尔士 🏴󠁧󠁢󠁷󠁬󠁳󠁿
英属维尔京群岛	英属维尔京群岛 🇻🇬
约旦	约旦 🇯🇴
约旦哈希姆王国	约旦哈希姆王国 🇯🇴
越南	越南 🇻🇳
越南社会主义共和国	越南社会主义共和国 🇻🇳
赞比亚	赞比亚 🇿🇲
赞比亚共和国	赞比亚共和国 🇿🇲
泽西岛	泽西岛 🇯🇪
泽西	泽西 🇯🇪
乍得	乍得 🇹🇩
乍得共和国	乍得共和国 🇹🇩
直布罗陀	直布罗陀 🇬🇮
智利	智利 🇨🇱
智利共和国	智利共和国 🇨🇱
中非共和国	中非共和国 🇨🇫
中非	中非 🇨🇫
中国	中国 🇨🇳
中华人民共和国	中华人民共和国 🇨🇳
五星红旗	五星红旗 🇨🇳
红旗	红旗 🇨🇳
阿森松岛	阿森松岛 🇦🇨
阿森松	阿森松 🇦🇨
布韦岛	布韦岛 🇧🇻
克利珀顿岛	克利珀顿岛 🇨🇵
迪戈加西亚岛	迪戈加西亚岛 🇩🇬
休达及梅利利亚	休达及梅利利亚 🇪🇦
休达和梅利利亚	休达和梅利利亚 🇪🇦
休达	休达 🇪🇦
梅利利亚	梅利利亚 🇪🇦
赫德岛和麦克唐纳群岛	赫德岛和麦克唐纳群岛 🇭🇲
法属圣马丁	法属圣马丁 🇲🇫
斯瓦尔巴和扬马延	斯瓦尔巴和扬马延 🇸🇯
特里斯坦–达库尼亚群岛	特里斯坦–达库尼亚群岛 🇹🇦
特里斯坦–达库尼亚	特里斯坦–达库尼亚 🇹🇦
台湾	台湾 🇹🇼
中华民国	中华民国 🇹🇼
美国本土外小岛屿	美国本土外小岛屿 🇺🇲
